sms => sms
kassi => cassia
emma => emma
gewinn => gain; win; getting
skalpi => scalp
betrau => bemoan; be sad
ununterbroch => uninterrupted
tell => teller
kopflos => acephalous
reicht => reached
experimenti => experiment; experimentation
russell => russell
zoom => zoom lens
tatowi => tattoo
loslass => loose; unclasp
diesel => diesel
tausend => thousands
normalisi => normalize; normalise; nomalize
dank => thanks; thank
amen => amen
hall => halle
chaos => chaos
ubernatur => preternaturally; supernaturally
fellow => fellow
blut => bled
solid => solid
liquidi => liquidate
dido => dido
reprasentiert => represented; represents
nist => nest; nestle
gold => golden; gold; gilded; gilt
unwiss => unknowing
fad => flat
ehe => ere
moment => moment; momentum
potenziell => potential; potentially
gabriel => gabriel
wusch => washed
sudkorea => south korea
pur => pure
fanat => fanatical; fanatic; fanatically
division => division
kain => cain
pflug => plough
massag => massage
formi => form; forming up
abbind => bond; bind
primitiv => primitiv; primitive
sinkend => sinking
revidi => revise; review
ermess => assess
klirr => clink
junction => junction
streb => strive
pedant => pedantic; pedantically; pedanticly
rhetor => rhetorical; rhetoric; rhetorically
konsequent => consistent; consequential; consequently; consequent; consistently
werk => to work
angesiedelt => resided
lloyd => lloyd
streif => streak; stripe
minos => minos
perl => sparkle
arthur => arthur
pol => poland; poles
vinzenz => vincent
befreit => freed
knips => clip
deaktivi => deactivate; inactivate
komite => committee
tar => tar
filip => philip
kniescheib => knee-cap
fantast => more fantastic
schizophreni => schizophrenia
goo => goo
paris => paris; parisian
vag => vague; vaguely
animal => animal
kgb => kgb
nagel => nail
streu => scatter; strew; spread; strewn
kniet => kneed; knelt
josephin => josephine
konventionell => conventional; conventionally; Conventional
stella => stella
fullt => filled
variiert => varied; variable; varying; variegated; variegates; varies
scharf => sharper
histor => historical; historical map
lilli => lily
gloria => glory
grau => grey; gray; drab
kaninch => lapin
edgar => edgar
elektron => electronically
signalisi => signal; signalize; to signalise
halbnackt => half-naked; half naked
just => just; just now
meth => meth
jung => junior; younger
taipeh => taipei
praktiziert => practises; practiced; practised
nina => nina
ankara => ankara
herzlos => heartless; heartlessly
aha => aha
mors => mortar
rov => rover
jeglich => each
darfur => darfur
erleuchtet => enlightened; enlightens; lighted
freigeb => free
nervt => nerves
sari => saree
schul => school
rac => racer
fettig => fatty; fat; fattily
gouda => gouda
chevy => chevy
rabbin => rabbi
bericht => right; straighten; set aright
platon => plato
operativ => operative; operational; operatively
herb => acerbic
chil => chile
vorhergeseh => foreseen
trust => trust
klaustrophob => claustrophobic
kibbuz => kibbutzim
wandeln => wander; walk
circa => circa
stampft => stamps
mikroskop => microscope
roug => rouge
christlich => Christian; christian; Christianly
afghanistan => afghanistan
kompliziert => complicated; complex
wortwort => word for word; word-for-word
dao => tao
gack => cackle; cluck
berat => deliberate; debate
schmelz => melt; smelt; scramble
kaff => coffee
wieg => swing
verstandnisvoll => understandingly
ram => ram
eleonor => eleanor
luth => luther
selbststand => self-contained; self-reliant
viktoria => victoria
fit => fit
apropos => apropos
horizontal => horizontal; horizontally
sowieso => at best
fahrlass => careless
renoviert => renovated; renovates
schein => shine
disqualifiziert => disqualifies; disqualified
interagi => interact
johanna => jane; joan
immunitat => immunity
dalton => dalton
tanz => dancer; dance
zwanzig => twenty
mental => mental; mentally
liliputan => lilliputian
delta => delta
guardian => guardian
brown => brown
uganda => uganda
notwend => needed
mai => may
konzentri => concentrate; center; centre; collect
versich => certify; vouch
sortiert => sorted; sorts
flattert => flitters; flutters
budap => budapest
kommando => commando
chip => chip
wind => wind
obszonitat => obscenity
bakteriell => bacterially
mystisch => mystical
konstrui => construct; construe
kindisch => childishly
sensibilitat => sensitivity
sir => siren
atmosphar => atmospherical
kultivi => cultivate; culture
rush => rush
ident => identical; identic; identically
schlaff => slack
einfug => infix
pikant => piquant; poignant; piquantly
verblendet => blends; blended; blinded
jason => jason
kurv => curving
voraus => forward
turk => turk
telegrafiert => telegraphed
us => us
galahad => galahad
delikat => delicate; delicious
hup => honk; hoot; hook
goliath => goliath
malmo => malmo
mandat => mandate
riski => risk
kultiviert => cultured; cultivated; cultivates
fiktiv => fictitiously
geformt => formed
relativ => relative; relatively; comparative
sodom => sodom
theoret => theoretical; theoretic; theoretically; in theory; theoreticly
atropin => atropine
samuel => samuel
ruth => ruth
unt => under
adelaid => adelaide
sack => sag; sack
maki => maki
lehnt => leaned; leant
einpack => pack
ol => ol
stinkreich => stinking rich
granit => granite
legend => legend
monaco => monaco
rio => rio
fuji => fuji
spargel => sparrowgrass
papaya => carica papaya
gelahmt => lame
flog => flew
dumbo => dumbo
ethisch => ethical; ethic; ethically
unterwandert => undermined
spendi => spend; stand; to spend
schnurrt => purrs
bereu => regret
packt => packs
montreal => montreal
simuliert => simulated; simulates
skandalos => scandalous; scandalously
relevant => relevant
undercov => under; undercover
synagog => synagogue
bangladesch => bangladesh
faszini => fascinate
schlachthaus => slaughterhouses
isoliert => isolated
furchtbar => frightful
unternehm => undertake; intend
doppelgang => doppelgangers; doppelgängers
orientiert => oriented; orientates; orientated; orients
produktivitat => productiveness
last => last
indian => Indian; Amerindian; Red Indian; amerindian; indian
selb => oneself; self; itself; myself; yourself; himself; herself
superb => superb
dito => ditto; dito
manipuliert => manipulated
setzt => set
ariel => ariel
betaub => benumb
rief => cried
hanoi => hanoi
stoppt => stops
halbiert => halved; halves
ind => indian
onion => onion
einschreib => inscribe
massig => massive; massy; mass
emboli => embolism
nord => north
bogotá => bogotá
erkling => ring
telegraph => telegraph
qualifiziert => qualified
regeneriert => regenerates; regenerate; regenerated
hongkong => hong kong
vorwarn => forewarn
mission => mission
schockier => shocking; shockingly
sydney => sydney
archimed => archimedes
bib => biber
bruchig => crumbling
einsetz => insert; invest
isa => isa
duld => endure
impulsiv => impulsive; impulsively
global => global; globally
industriell => industrially
ade => adieu
regal => regal
schick => chic
sozial => social; societal; socially
schleimig => slimly
galli => gaul
paddeln => paddle; wade
thema => theme
kritisch => critical; critically
bibliothek => bibliothek; bibliotheca
sal => salaam
plaud => prate
blami => blame
control => control
kommt => comes
zwo => two
entschied => clinched
eskaliert => escalates
trunk => trunk
befindet => finds
apart => apart
spanierin => spaniard
pathologi => pathology
unertrag => unendurably
dust => duskier
test => test
delhi => delhi
komplex => complex; complicated; complexly; combined; composite
muslim => muslim
national => national
ostwart => eastward; eastwards
wyoming => wyoming
volt => volts
zwitsch => twitter
rechtmass => rightful; legitimate
aussert => utters
gibbon => gibbon
elias => elijah
vorgestellt => suggested
zuerst => first
verweil => dwell
bambi => bambi
scratch => scratch
amputi => amputate
chamaleon => cameleon
graham => graham
gas => gas
miaut => miaows; miaoued; miaous; miaowed
aquarius => aquarius
sahara => sahara desert; sahara
ubertreib => overdo; overstate; overact
testet => tests
melissa => melissa
tort => torte
undankbar => unthankfully
positioniert => positioned; positions
ludlow => ludlow
pech => pitch
reprasenti => represent; represents
amerikan => american; americans
solo => solo
realisi => realize; actualize; realise
boarding => boarding
unkontrollierbar => uncontrollable; uncontrollably
mond => moon
betrink => get drunk
verspatet => belated
anti => anti
rou => rouen
kollidi => collide; conflict; collide with
net => not
addiert => added
plundert => plunders
horst => horst
produziert => produced; produces
bewein => bewail
thorn => thorn
koordini => coordinate
operator => operator
libanon => lebanon
knietief => knee-deep; knee-high
mumbai => mumbai
credit => credit
margarin => marge
duscht => douches
krokodil => croc
meer => deep
commonwealth => british commonwealth; commonwealth
einflussreich => influential
uberblick => overlook; oversee; overview
unbestand => uncertain; unsettled; unstable; inconstant; unsteady
west => west
unpartei => impartial; nonpartisan
eingetret => entered
kompromittiert => compromised
stabil => stable
delphin => dolphin
beleucht => light
lucretia => lucretia
ratt => rat
uberlastet => overburdens; overburdened; overcharged; overextended; overload; overloaded; overloads; overstrained
somm => summer
einsack => sink
birma => burma
synthet => synthetic; synthetical; synthetically
els => else
elektr => electrically
gail => gail
atrium => atrium
beaujolais => beaujolais
effizient => more efficient
minimi => minimize; minimise
geniess => relish
diktatur => dictatorship; dictate
haitian => haitian
fatal => fatal; lethal
melbourn => melbourne
bah => bah
beitret => enter
sc => sc
te => te
delegiert => delegated
spezif => specific; specifically
toleriert => tolerated; tolerates
phoenix => phoenix
bounty => bounty
monti => mount
tschechi => czechia
kapituli => capitulate
awesom => awesome
bindung => bonding; linking
simpel => simple; simply
soll => shall; should
halb => half
zink => zinc; zink
am => at; am
rebelliert => rebelled; rebels
vortex => vortex
etabliert => established
meditiert => meditates; meditated
erfrischt => straight
besprech => bespeak
lenk => lead
uberrumpelt => overpowers
indiana => indiana
anderthalb => one and a half
uberlast => overload; overstress; overwork; overtax
unbewusst => unawares
rezitiert => recites; recited
konsol => console table
kalkuliert => calculated
sollt => should
damon => demonic
ungult => null
pfund => pound; pounds
leichtfert => light
bermudas => bermuda; bermudas
angus => angus
untergrab => undermine
fick => fuck; fucking
penicillin => benzylpenicillin
spann => spun
gottin => göttin
scheisst => shits
arminius => arminius
find => find
hofft => hoped
beaumont => beaumont
form => form; forge
brit => brit; britisher; briton
knick => crack
lincoln => lincoln
phras => phrase
stockwerk => storey
bildung => breeding
schrill => shrill
wu => wu
medizin => medical; medicinal; medically; med; medic; medicinally; medicated
schrubb => scrub; scour; rub
konrad => conrad
adoptiert => adopted
skrupellos => unscrupulous; unscrupulously
fred => fred
objektiv => objectively
konservi => preserve; conserve
manovriert => maneuvers
fiedl => fiddler
yin => yin
unorthodox => unorthodox; nonorthodox; unorthodoxly; non-orthodox; unorthodoxy
katholikin => catholic
omaha => omaha
inkognito => incognito
bulldog => bulldog
synapt => synaptic
persi => persia; persian
wandelt => walked
zufall => casually
surrt => whirrs
barbara => barbara
anastasia => anastasia
bass => bass
teuerst => dearest
hohl => hollow
technicolor => technicolor
wolga => volga
extraktion => extraction
vermont => vermont
bitterkalt => bitter; bitterly cold
deserti => desert; defect
aufdring => pushing
scharlach => scarlet
kaschmir => kashmir
sagt => says
uberrumpeln => overpower
rock => rock
grun => green
mem => mem
grund => found
defekt => defective; defect
filz => felt
sinnlos => senseless; pointless; mindless; silly
infiltri => infiltrate
enigma => enigma
uberspr => overjumped; overleaped; overleapt
anfecht => assault; attack
metaphor => metaphorical; metaphoric; metaphorically
mel => mel
abkratz => scrape
rhythmisch => rhythmically
schrank => rack
macon => macon
klassisch => classical; classic; classically
handhab => handle
dekadenz => decadency
klargestellt => clarified
sparta => sparta
romant => romantic
po => po
dankend => thanking
konfuzius => confucius
uninteressant => uninteresting; of no interest; uninterestingly
grand => grand
entflammt => inflames; inflamed
isaak => isaac
mimi => mimi
fixi => fix; fixate
beschw => bitch
salutiert => salutes; saluted
august => august
sexuell => sexual; sexually; sex
lacht => laughs
itali => italy
chanukka => chanukah; hanukah
denunzi => denounce; denunciate; denounce publicly
ungerad => uneven; unlevel; unequal
gesponn => spun
allerg => allergic; allergically; allergenic
sektion => section
bissig => biting
surr => to purr
leo => leo
traut => trusts
terpentin => turpentine
individuell => individuals
geschnuffelt => sniffed; snuffed; snuffled
herm => hermes
standhaft => steadfast; staunch
ukrain => ukraine
stinkend => stinking; stinky
contain => container
begann => began; begun
gewonn => won
hierfur => therefore; therefor
uran => uranium
provinz => province
wurd => were
iran => iranian
applaudi => applaud; acclaim
pipelin => piping
nobl => nobler
bildet => built
wust => waste
dat => date; data
human => humane; human; humanely; human being
darr => dry
subtil => subtle; subliminal; subtly; subtile
neck => heckle
berni => bernie
first => first
rezeption => receptionist
ideal => ideal; ideally
de => de; dee
initiiert => initiated
schwind => shrink
regel => precept
verwustet => wasted; wastes
oregon => oregon
destabilisi => destabilize; destabilise
mistress => mistress
uberwalt => overpoweringly; overwhelmingly
maschin => machine
bora => bora
uberwacht => oversaw
superintendent => superintendent
woll => will; woolen; woollen; woolly
hisst => hoists
london => london; londoner
pyramid => pyramid
bemannt => manned
flieh => flee
kopf => top; cut off
gezittert => jittered
lukas => luke
punkt => points
deponiert => deposites; deposited
algi => algiers
pontifex => pontifex
scheut => eschews
sabrina => sabrina
interpreti => interpret
pap => pap
gehandelt => dealt; merchandised; merchandized
port => porter
drastisch => drastic; drastically
kompensi => compensate; compensate for
krypton => krypton
ministerium => ministry
koordiniert => coordinately; coordinated; coordinates
rasant => fast; dashing
grant => grant
ausdiskuti => to dispute
gewinnt => gains; wins
flott => afloat
argument => argument
dahint => behind; behind it; behind that
peer => peerage
denkt => thinks
brau => brew
chuck => chuck
begrund => found
leb => live
schokolad => chocolate
optimist => optimistic; optimistically
egoist => selfish; egoistic; egotistic; egoistical; egoistically; egotist; egotistical
ausrust => appoint
angestiftet => instigated; abetted
abtrenn => abstain
klara => clara; clare
videorekord => videocassette recorder
kapi => copy
projiziert => projected; projects
mantl => mantle
realisiert => realizes; realised; realized
park => park; parking
reaktivi => reactivate; rehabilitate
elan => elan
gegrundet => founded; grounded
metamorphos => metamorphosis
jana => joan
roti => rotate
modern => modernest; most modern
spritzt => sprayed
permanent => permanent; permanently; persistent
bronco => bronco
glitzert => glistens; glitters
jiddisch => Yiddish; yiddish
kurdisch => Kurdish; kurdish
klamm => more clammy
vanill => vanilla
sozusag => so to say
kritisiert => criticizes; criticised; criticises; criticized; critiqued; critiques
berg => bear
boykott => boycott
observi => observe
bedurf => require
ciao => ciao
fitness => physical fitness
ruini => ruin
pongo => pongo
monogami => monogamy
typisch => typical
magic => magic
homecoming => homecoming
banal => banal; banally
uberlad => overload; overcharge
taiwan => taiwan
hackt => hacked
argos => argos
karussell => carrousel
telefoni => telephone
rattert => clatters
alabama => alabama
aussorti => assort
respektlos => disrespectful; disrespectfully; unrespectful
clean => clean
fabian => fabian
erlass => release
kokosnuss => coco palm; coconut palm
reguliert => regulated; regulates
hudson => hudson
feiern => fete
kairo => cairo
paranoid => paranoidal
bakteri => bacterium; eubacteria
guinness => guinness
big => big
saboteur => saboteur
findet => finds
weston => weston
moe => moe
oktopus => octopuses
softwar => software
nil => nile
amerika => americas; america; amerika
salom => salome
polizei => police
bridget => bridget
glasklar => glassy
sex => sex
uberaus => very; overly
lang => longest
augsburg => augsburg
sorti => sort; assort; sort out
nevada => nevada
befund => found
burma => burma
massiert => massages; massaged
besinn => bethink
fakultat => faculty
boah => whoa
wimm => whimper
bra => bra
kalium => potassium
makkaroni => macaroni
fuhr => steer
neugebor => newborn; new-born; new born
unbedacht => unthought
pass => pass
taylor => taylor
glatt => flat
mik => mike
boeing => boeing
dvd => dvd
evolution => evolution
befreiend => freeing
bindet => binds
folgt => follows
dezimiert => decimates; decimated
kochend => cooking
fragil => fragile
wai => wai
gebor => be born
meschugg => meshugge; meshuga; meshugah; meshuggah; meshugga
kar => karen
mordechai => mordecai
versenkt => countersinks
anfreund => friend; make friends
chemisch => chemical; chemically; chemistry
kontamination => contamination
eingenomm => ingested
micha => micah
spezifizi => specify
blockad => blocking
natur => natural; naturally; native
unterbesetzt => understaffed; undermanned; understaffedly
eispickel => pick
triumphiert => triumphs; triumphed
lamas => lama
kolumbi => colombia
geblinzelt => blinked
gesponsert => sponsored
pjongjang => pyongyang
kredit => credit
international => international; internationally; external; intergovernmental
hi => hi
georgi => georgia
ubergluck => overjoyed; overhappy; overjoied
blutlini => bloodline
anal => anal; anally
alarmiert => alarmed; alert; alerted
beantwortet => answered
injektion => injection
wartet => waited
kompromisslos => uncompromising; uncompromisingly
fleet => fleet
top => top
einlogg => log
salb => balm
nervtot => unnerving
festival => fest
magnesium => magnesium
auffind => find; refind
harmon => harmonical
konstruiert => constructs; construes; constructed; construed
versaumt => overstays; overstayed
brigitt => bridget
entgegentret => encounter
rud => rude; rudely
kommentiert => commented; comments
schreiend => crying
formlich => formal; formally; formerly
surf => surf; surfing
korsika => corsica
dupont => dupont
wichita => wichita
einschliess => includes
manovri => maneuver; manoeuvre; maneuvering
murr => murmur; mutter
collin => collins
glasgow => glasgow
schild => shield
audio => audio
verstau => stow; bestow
replizi => reply; to replicate; replicate
elisabeth => elizabeth
blendet => blinds
einrahm => enframe
horus => horus
sudafrika => south africa
hoffend => hoping
plan => plan; plot
fabelhaft => fabulous
wien => vienna
sam => sami
neuengland => new england
fabriziert => fabricates; fabricated
tatowiert => tattoos; tattooed
schamlos => shamelessly
irreparabel => irreparable; irreparably; irremediable; irreparabel; unrepairable
traini => train
klima => climate; clime
pathet => pathetic
gebracht => brought
ripp => rip; rip off; ripping
livius => livy
protein => protein
jugoslawi => yugoslavia; jugoslavia
pippin => pepin
komfortabel => comfortable; comfortably
imperialismus => imperialism
ali => ali
untersagt => interdictive
tropft => drops
eleganz => elegancy
idaho => idaho
offlin => offline; off-line
lissabon => lisbon
zwitschert => twitters
aufhetz => abet
aufmunt => amuse
kostenlos => costless
backbord => larboard
rick => rick
bethleh => bethlehem
kent => kent
dialys => dialysis
munt => jaunty
nairobi => nairobi
kabeln => cable
michigan => michigan
inoffiziell => nonofficially; unofficially
islamabad => islamabad
nebenan => near
chicago => chicago
murmeln => mumble; murmur; mutter
generi => generate
morg => morning; mornings
columbia => columbia
perfektioni => perfect; perfection
casar => caesar
esth => esther
detoni => detonate
gepfluckt => plucked
sparlich => sparse; scarce
unterbricht => intermits; interrupts
full => fill; call; fill up; fills
trab => trot
hering => sea herrings
gam => game
hamm => hammer
improvisiert => impromptu; improvised; improvisational; improvises
kathol => Catholic; catholic; Catholically
redakteur => editor
kleopatra => cleopatra
ii => ii
england => englishman
solang => so long as
string => stringer
by => by
borneo => borneo
regnet => rained
dasein => dasein
riga => riga
niet => rivet
prasent => present
abreiss => break
diskuti => discuss
braun => brown
computerprogramm => computer programme; computer software
ausserst => outermost
trail => trailer
rav => rave
plant => planned
funfzehn => fifteen
abweg => wayward
manch => manchester
kranich => crane
springfield => springfield
radiesch => radishes
gazett => gazette
bush => bush
senil => senile
mini => mini
bp => bps
bedeck => back
pinkelt => tinkled
infiziert => infected; infects; inflamed
pompeius => pompey
schatzung => rating
reptil => reptilia; reptilian
uberreagi => overreact
josefin => josephine
gesprung => sprung
verkundet => heralds
projekt => projects
elegant => elegant; elegantly
bet => beg
lost => looses
algeri => algeria
tickt => ticks
transplanti => transplant
gottlos => godless
mediti => meditate
bizarr => bizarre
km => km
sec => sec; secant
negativ => more negative
irland => ireland
portal => portal
relais => relay
ober => over; outer
clip => clip
tabak => tobacco
uberschatz => overestimate; overrate
verheil => heal; be healed
bedrangt => throngs
leukami => leukemia
kanal => channel
bohnenstang => beanstalk
box => box
sank => sank
family => family
thrak => thracian; thracians
g => g
ungeniessbar => unenjoyable
kambodscha => cambodia; kampuchea
uberall => universally
kanada => canada
rund => rotundly
platsch => splash
nemesis => nemesis
schlief => slip
hightech => hightech
nordwart => northward; northwards; north; northbound; northerly; to the north
lebensform => lifeform; lifestyle
geholt => got
sensor => sensor
hyan => hyena
andermal => another day
reagiert => reacted
landmin => landmine
heat => heat
stalk => stalk
kreb => crab
gesenkt => sunk
hermann => herman
prometheus => prometheus
script => script
bekraft => bear out
verzwickt => tricky
kaviar => caviar
attackiert => attacked
sitzend => seated; sitting
luis => louisa
ladt => lades; loads
amy => amy
einsteig => enter
bukar => bucharest
stockholm => stockholm
leic => leicester
held => held
resistent => resistant; resistent
dos => dose
gehackt => hacked
transferiert => transfers; transferred; transferred <transfered>
absolvi => absolve
regeneri => regenerate; recover
estland => estonia
martini => martini
befleck => defile
munst => moister; muenster; münster
motherfuck => motherfucker
legitim => legitimate; legitimately; legit
mandarin => mandarin
bietet => bids
brullt => squalls
fokussiert => focused; focuses; focussed
cornwall => cornwall
limog => limoges
steuerfrei => tax-free; scot-free; tax free
exot => exotic
geschockt => shocked
leucht => be bright
kron => crown
stationiert => stationed
ubertrumpf => overtrump; trump
trompet => trumpet
bh => bh
wortlos => wordless; wordlessly
hetero => heterosexual; hetty; hetero
hera => hera
fasziniert => fascinated
zyp => cyprus
edinburgh => edinburgh
skeptisch => sceptical; skeptical; skeptic; sceptic; sceptically
hungrig => hungrily
uncool => uncool
roma => romani; romany
handschell => handcuff
funktioniert => functioned
syr => syrian
planung => planning
tropf => drop
marin => maritime; marine
tap => tap
blindheit => blindness
dschinn => djinn
wunderbar => more wonderful
togeth => together
schabig => shabby
asyl => asylum
abklar => clear
concha => concha
immun => immune; immun
boost => booster
kohlenhydrat => carbohydrate
unfassbar => unfathomable
verbarrikadiert => barricades; barricaded
logisch => logical; logically; -logical; logic
argo => argo
klick => quickly
installiert => installs; instaled; installed; instals
frustrier => frustrating; frustratingly
lothring => lorraine; lothringen
angel => angel
verschuldet => beholden
vernichtet => exterminated
souveran => sovereign
optisch => optically
goofy => goofy
uberanstrengt => overstrained; overstrains; overexerts; overworks
guis => guise
zement => cement
colli => collier
lackiert => lacquered; lacquers
steuert => steers
terrorisi => terrorize; terrorise
existenz => presence
abwasch => wash
microsoft => microsoft
riesengross => tremendous
tip => tip
pack => pack; package
tuba => tube
mix => mix
fauna => fauna
lockt => clucks
jakarta => jakarta
geklont => cloned
justi => justify; adjust
distanziert => distant; detached
quitt => quits; quit
einzeln => single; singly
mannlich => masculine; manly
plazenta => placenta
dext => dexter
rostet => rusts
irritier => irritating
abstrakt => abstract; abstractly; abstractedly; abstruse
circus => circus
olli => ollie
bankrott => bankrupt; bankruptly; bankruptcy
arizona => arizona
abgetrieb => abortive; aborted
basiert => based
schnurr => purr
unterhalt => entertain
liegt => lies
jago => iago
beantwort => answer
steinreich => stinking rich
vermarkt => market
abraum => abstract
farblos => sallow
guido => guido
qualifizi => qualify
freigegeb => freed
fidschi => fiji
hiv => hive
gekratzt => grated
konfiguriert => configured; configures
enthusiast => enthusiastic; enthusiastically
rc => rc
tendi => tend; trend
drach => drake
dasselb => itself
gulasch => goulash
frequenz => frequency
bevor => before
ubersieht => overlooks
isabella => isabel; isabella
caracas => caracas
nix => nix
marshall => marshall
konzentriert => concentrated; concentrative
drei => three; trey
angeb => alleged
konsulti => consult
davy => davy
merlot => merlot
lynch => lynch; lynching
greif => grip
daidalos => daedalus
symbol => symbolic; symbolical; symbolically
rettet => rescues; retrieves
aktiviert => activated; activates
glitt => glided
schnappschuss => snapshot
angreif => aggress
verwust => waste; lay waste
gaia => gaia
terry => terry
alfred => alfred
umschreib => circumscribe; describe
toskana => tuscany
violett => violet; violett
verfein => refine
flucht => take flight
halluziniert => hallucinates; hallucinated
undiszipliniert => undisciplined
spinat => spinach
verwelk => wilt
parat => pat
nett => nicest
experimentell => experimental; experimentally
camd => camden
knurrt => snarls
heil => well; healthy
indio => indian
fiesta => fiesta
paarweis => pairwise; pair; paired; pair in pairs
kommunismus => communism
kongressabgeordnet => congresswoman
unbeschreib => indescribable; undescribable; undescribably
morpheus => morpheus
he => hey; hi
investiert => invests; invested
inklusiv => inclusive; inclusive of; included; including; inclusively
exporti => export
adressiert => addressed
bizeps => bicep
hundertprozent => one hundred percent; hundred per cent; hundred percent
leda => leda
lol => lol
murmelt => mumbled; murmured
faktisch => factual; practical
tansania => tanzania
unbeschadigt => unscathed; unspoilt
kopenhag => copenhagen
uneingelad => uninvited
stefan => stephen
korea => korea
posti => position; post
halbtot => half-dead
ge => ge; gee
weideland => rangelands
unwohl => unwell
imperial => imperial
restauri => restore; re-establish
eug => eugene
scheint => shines
oklahoma => oklahoma
mittl => middle; middling
muti => mutate
makeup => makeup
largo => largo
explodi => explode
befall => befall
nanking => nanjing
fix => fixer
dargelegt => argued
beneidet => envies; begrudges; envied
sternenflott => starfleet
anbind => bind; combine
vorangetrieb => forwarded
galant => gallant
unterschatz => underestimate; underrate; undervalue
true => true
unbesiegbar => unbeatable
spiess => spike
gespritzt => spritzed
belgi => belgian
pr => pr
anstreb => aspire
nestor => nestor
undeut => unclear
rasseln => rattle
protestiert => protested; protests
hebra => hebrew; hebrews
intubi => intubate
idyll => idyllic; idyllically
intern => internal; internally
allerding => albeit
unbesiegt => unbeaten
provokativ => provocative; provocatively; provoking
ubermudet => overtired
nachfull => refill
louvr => louvre
black => blackout
bereich => enrich
ns => ns
jock => jock
regeln => regulate
eut => teat
respektiert => respected
beirut => beirut
bell => bell
wei => wei
eingedr => invaded
strukturell => structurally; texturally
penelop => penelope
post => post
kronos => cronus
zylind => cylinder
versetz => set
akust => acoustically
neb => near; next; nearby
null => null; nil
trampeln => trample; tramp
kalkutta => calcutta; kolkata
neutralisiert => neutralizes; neutralised; neutralized
pakistani => pakistani
vorangeh => forego
money => money
ausfall => fail; assail; assault
lot => lot
rausschmeiss => dismiss
uberspringt => overjumps; overleaps
emir => amir
japanerin => japanese
saw => saw
stoneheng => stonehenge
empfindet => experiences
diskriminiert => discriminated; discriminates
mailand => milan
intuitiv => intuitive; intuitional; intuitively; intuitionally
harald => harold
jimmy => jimmy
versus => versus
erspart => spared
ejakulation => ejaculation
eingenistet => nested
sting => sting
kurd => kurds
uberlagert => overlais; overlayed; overlaid; overlain; overlays
nordkorea => north korea
ansprechbar => approachable
schwimmt => swims
angelt => angles
veronika => veronica
delawar => delaware
inspiri => inspire
tick => tick; tick-tock
impliziert => implied; implicit; implies
singt => sings
asa => asa
lena => lena
bespruh => spray; spur
ubertrieb => over the top; overdone
englanderin => englishwoman
head => head
reisepass => pass
destruktiv => destructive; destructively; counterproductive
typ => types
chrom => chromium
cayenn => cayenne
stopp => stop
bedankt => thanks
exekuti => execute
kreisch => screech
tommy => tommy
lucky => lucky
entfaltet => unfolded
palo => palo
sandy => sandy
bodenstand => longstanding
konfronti => confront
gestrandet => stranded
savoy => savoy
signiert => signed; signs
trivial => trivial; trite
proletariat => proletariate
golf => golf
unhorbar => unhearable
blutet => bled
eden => eden
rastlos => restless
cart => carter
parkt => parked
extr => extreme; extremely
brutus => brutus
inhali => inhale
albrecht => albert
nordost => northeast
vakuum => vacua
tschernobyl => chernobyl
unkontrolliert => uncontrolled; uncontrolledly; uncontrollably
verhindert => hindered
schlurft => scuffs
schutz => shuttle
klump => to lump
abgestempelt => stamped
capa => cape
tramp => tramp
feinfuhl => fine
othello => othello
respektabel => respectable
unrealist => unrealistic; unrealistically
honey => honey
monk => monk
modus => mode
kanalisation => sanitation
befeucht => benefit
pepp => pepper
renovi => renovate
beautiful => beautiful
einheit => unit
symmetr => symmetrical; symmetric; symmetrically
gesandt => sent
cut => cut
bureau => bureau
mercury => merc
erstklass => first-class; first class; class; classy
registriert => registered
ungewohnt => unwonted
watch => watch
oper => opera
demoliert => demolishes; demolished
jb => jb
khaki => khaki
programmiert => programed; programmed
indianerin => indian
schwirrt => whirrs; whirs
visionar => visionary
pervers => more perverse
zwick => tweak; twitch
katalogisiert => cataloged; catalogued
olympiad => olympiad; olympics
auffrisch => refresh
amb => amber
grossmama => grandma
bosni => bosnia
thems => thames
wow => wow
hasta => hasta
meet => meet
miami => miami
baum => bar
unterschatzt => underrated; underestimated; underestimates; underrates; undervalues; underappreciated; undervalued
palastinens => palestinian; palestinians
tripl => treble
provenc => provence
oft => often
motivi => motivate
margaret => margaret
franzosin => frenchwoman
bowman => bowman
vermischt => intermingles
biochemi => biochemistry
final => final
defianc => defiance
mitteil => tell
barnabas => barnabas
rei => rei
stock => stick
kostspiel => costly
robust => robust; robustly
kontakti => contact
stroh => straw
ludo => ludo
saturn => saturn
schlapp => slack
chrysl => chrysler
mohammed => muhammad; mohammed
ubertrug => overtopped
batteri => battery
offensiv => offensive; aggressive; offensively; aggressively
neapel => naples
burbank => burbank
getrunk => drunk; drank
davon => thereof
britanni => britain; britannia
unahn => unalike
dm => dm
ultra => ultra
peng => bang
lazarett => lazaretto
leih => lend
mangeln => mangle
denv => denver
senkrecht => upright; straight; direct
attila => attila
flitz => flit
nachhelf => help
johnny => johnny
zero => zero
dns => dna
kiel => kiel
gangmitglied => gangbanger
primus => primus
unterschrieb => underwritten; undersigned
denunziert => denunciated
leckt => leaked; licked
anonymous => anonymous
parfum => perfumery
edda => edda
kont => counter
unfreiwill => uninentional
reisst => rips
metall => metal
kitschig => kitsch; kitschy
verhex => hex
biopsi => biopsy
minus => minus; minus sign
via => via
option => option
wisconsin => wisconsin
ob => ob; or
pac => pace
konstruktiv => constructive; structural; constructively; positive; constructional; productive
kreativitat => creativeness
palermo => palermo
beeilt => speedily
ha => what
charli => charlie
cowboy => cowpoke
gewandert => wandered
schlummert => slumbers
asia => asia
inning => innings
unbeschadet => unscathed
scotch => scotch
seth => set
mietfrei => rent-free
minor => minor
bologna => bologna
katalogisi => catalogue; catalog
casp => casper
kraftvoll => powerfull
basi => base
telefoniert => telephoned
krim => crimea
isis => isis
brem => brakes
daisy => daisy
pie => pie
lorenz => lawrence
ungenau => unexact
ci => ci
regina => regina
einsteck => insert
respektvoll => respectful; respectfully; reverentially; regardful
tuberkulos => tuberculosis
gras => graze
gehupft => leapt
nas => nose; nosing
konfus => confused; in confusion
rebell => rebellious; rebelliously; rebel
schussel => vessel
jodeln => yodel
erwartet => awaited
abermal => after all
ins => into
charismat => charismatic; charming
ahm => awm
gratis => gratis; gratuitous
gericht => bench
cal => cal
uniform => uniform; military uniform
beneid => envy
nurnberg => nuremberg
zwickt => tweaks
andert => amended
abbring => wring
shaft => shaft
soundso => so-and-so
elvira => elvira
uberflieg => overfly
chinesin => chinese
lombard => lombard
chic => chic
kontrolliert => controlled; controled
ms => msec
susann => susan
rumani => romania; rumania
sympath => sympathetic; simpatico
passiert => passes; passed
kompatibel => compatible; compliant
beig => beige
navarra => navarre
sizili => sicily
dekori => decorate; deck out
feiert => feted
solomon => solomon
janic => janice
schopf => scoop
hindu => hindu
scorch => scorch
colorado => colorado
flop => flop
teleporti => teleport; teletransport
browning => browning
zweifach => twice
eva => eva; eve
asthet => aesthetics
ward => were
perfektioniert => perfected; perfects
rau => raw; raucous
pos => pose
multipliziert => multiplied; multiplies
formuliert => formulated; formulates
check => check
protesti => protest
whitehall => whitehall
uberschwemm => overflow
hipst => hipster
elbisch => Elbian; elvish
stech => stick; stitch
central => central
wynn => wynn
erhang => hang
positioni => position
benjamin => benjamin
vierhundert => four hundred
beta => beta
manipulativ => manipulative
unub => unusual; unusable
jupit => jupiter
prophezeit => prophesied; prophesies
schaukeln => shake
eingetrag => entered
wassertank => water tanks
blablabla => blah blah blah
luzif => lucifer
infrastruktur => infrastructure
festig => fasten
charity => charity
uberbiet => overbid; overcall
taktisch => tactical; tactically
duldet => endures
immerfort => evermore
wint => in winter
botan => botany
dokumentiert => documented
uberhauft => overwhelmed
unvollstand => uncompleted
sylvia => sylvia
cm => cm
aram => aram
divers => diverse
viktor => victor
mea => mea
plato => plato
nament => namely; nominal
wanda => wanda
tschechoslowakei => czechoslovakia
ontario => ontario
janina => jane
praxis => praxis
tm => tm
phonix => phoenix; phenix
smart => smart
comic => comics
julia => julia; juliet
gelehnt => leant
start => start; start up
lappland => lapland
knet => knead
brenn => burning
montag => mount
tweed => tweed
thrill => thriller
mineral => metal
versklav => enslave
verbal => verbal; verbally
bruno => bruno
claudius => claudius
pompeji => pompeii
profiti => profit
fe => fe
illinois => illinois
anmerk => mark
sucr => sucre
eskali => escalate
kenia => kenya
elementar => elementary; rudimentary; elemental; fundamental; rudimental; elementally; elementarily
magellan => magellan
indonesi => indonesia
marokkan => moroccan
pod => podium
nagelt => nails
stephani => stephanie
epi => epi
rehabilitiert => rehabilitates
reib => rub
strebt => strives
norweg => norway
rotterdam => rotterdam
excalibur => excalibur
konsumiert => consumes; consumed
at => at; ate
selbstlos => selfless; selflessly; unselfishly
enzym => enzyme
satt => sated; satiated
frankreich => france; french republic
litau => lithuania
mentalist => mentalist
heilbutt => halibut
antonius => anthony
physik => physics
helsinki => helsinki
mega => mega
vatikan => vatican
kaffe => coffee
bermuda => bermuda
kreiert => created; creates
morris => morris
sak => saké
fin => fine
birman => burmese
wal => wal
offn => open; open up
gestarrt => stared
felicity => felicity
makrel => mackerel
schelt => scold
wellington => wellington
okay => okay; ok; okey
uneth => unethical
februar => february
kaltherz => cold-hearted; coldhearted
cartagena => cartagena
signi => sign; designate
pick => peck; pick; peck at; pick at; pick up; pinch
beherberg => shelter
anno => anno
hakenkreuz => hakenkreuz
morgan => morgan
missouri => missouri
back => bake
profitabel => profitable; profitably
columbo => columbo
mild => amiable; kind
siam => siam
who => who
sonn => sun
vicomt => vicomte
friedrich => frederic; frederick
verbreitet => bruited
friend => friend
industri => industry
kindlich => childish
unterstrich => underlined; underscored
godfath => godfather
adopti => adopt; adoption
model => model
kosovo => kosovo
unsensibel => insensitive; nonsensitive; insensitively
duelli => duel
java => java; djawa
verrottet => rotten; rotted; rottens
windet => twines
ion => ion
buddhismus => buddhism
qin => qin
hawaii => hawaii
chinin => quinine
kooperativ => cooperative
verpflichtet => obligates
klinisch => clinical; clinically
weilt => dwells
leonardo => leonardo
holocaust => holocaust
befurwort => support
judy => judy
alberta => alberta
roh => raw; rough
experimentiert => experienced; experimented; experiments
chinatown => chinatown
tank => tank
muttertag => mother's day
halo => halo
rulpst => burps
paramet => argument
stimulier => stimulating; stimulant; stimulative
sanft => soft
monch => mönch
falschlich => false; falsely
teheran => teheran; tehran
morphin => morphine
kreta => crete
irrt => errs
hangt => hangs
lum => lumen
polnisch => Polish; polish
studi => study
sheng => sheng
wassermelon => watermelon
zersplittert => split; gone splintersed
schummeln => chisel
puh => pooh
zon => zone
sabotiert => sabotaged; sabotages
kontinui => continuous; constantly; continual; continually; continued
aufgelistet => listed
krach => crash; crack; crunch
liquidiert => liquidated
passi => pass
unbeobachtet => unobserved; unwatched
wohl => well
vibri => vibrate; vibration
tyrannisi => tyrannize; to tyrannise
kommandiert => commanded; commands
demokrati => democracy
violet => violet
karolin => caroline
transferi => transfer; to be transferred
geschmuggelt => smuggled
aden => aden
eingesetzt => inset
westwart => west; westward; westwards; westbound
unbewacht => unwatched
athiopi => ethiopia
chill => chill; chill out
morder => murderous; murder
wladimir => vladimir
sudwest => southwestern; southwesterly; south western; south-western; southwest; south-west
zuschreib => ascribe
vorn => before; fore; forward
stank => stung
sudamerika => south america
cab => cab
erhangt => hung
ungeschor => unshorn
mod => modern
meisterhaft => masterly; masterful; magistral
aga => aga
tour => bout
ubergewicht => overweight
unzuverlass => uncertain
transformiert => transforms; transformed
fixiert => fixed; fixes; fixated; fixates
kokain => cocaine
guatemala => guatemala
formuli => formulate
baby => bub
ying => ying
richtlini => outline
lustvoll => lustfully
motor => motors
freedom => freedom
entspring => spring
schaurig => scary
generation => generation
sensation => sensation
vektor => vector
vorfind => find
passé => passé
brannt => burnt
erlaut => explain
violetta => violetta
trommeln => to pelt
dijon => dijon
rar => rare
wann => when
dusch => douche
constanz => constance
betat => operate; actuate
generiert => generated
item => item
ubermorg => overmorrow
provoziert => provokes; provoked
reguli => regulate; regularize
ertapp => grapple
ur => ur
komplexitat => complexity
lt => lt
pulli => pullover
umhang => hang
uberfahr => overrun
valentin => valentine
amerikanerin => american
transparent => transparent; translucent
gescannt => scanned
shorty => shorty
ey => hey
ebn => level; even out; even; to even
me => me
lyrik => lyricism
frucht => fruit
hiervon => hereof; thereof
unternimmt => undertakes
angebor => inborn
zwisch => twixt
nachlass => careless
vesp => vesper
balkan => balkans
schu => shu
sung => sacking
skilauf => ski
definiert => defined; defines
demoli => demolish
ras => race; rage; rush; dash; rave
bas => base
espresso => espresso
urban => urban; urbane
saen => sow; seed; scatter; sown
improvisation => extemporization
new => new
bio => bio
prasentiert => presented
fusion => fusion
kanadierin => canadian
stromt => streamed
reproduziert => reproduces; reproduced
florenz => florence
bindend => binding; stringent
plagt => plagues
dvds => dvds
mayday => mayday
blinzeln => blink
interpol => interpol
ayutthaya => ayutthaya
unternomm => undertaken
muffig => mustily
chief => chief
berst => burst
interessiert => was interested in
plymouth => plymouth
beraub => bereave; bereaved; bereft
dekan => dean
vill => ville
hochinteressant => most interesting; very interesting
abcheck => check; to check
vened => venice
unterfang => undertake; undertaken; to underpin; undertaken}
nazareth => nazareth
rebelli => rebel; revolt
untergrabt => undermines
erreich => reach
fesseln => fetter
gelistet => listed
vibriert => vibrates; vibrated
pandora => pandora
wilton => wilton
meteor => meteor
nominiert => nominates; nominated
mc => mc
mason => mason
projizi => project
gepisst => pissed
definitiv => definite; definitely; definitive; positive; definitively
piepst => cheeps; peeps
beschriftet => inscribes; inscribed
unnatur => unnaturally
festbind => fasten; bind
keck => cheeky
phantast => fantastic
vx => vx
entourag => entourage
vertikal => vertical; vertically
anschwell => swell
gamma => gamma
investition => investment
reproduzi => reproduce; reproduces
luft => air
glamour => glamour
versenk => sink; countersink
kuppeln => couple
shunt => shunt
anthropologi => anthropology
episch => epical; epic
abgehob => aloof
stiehlt => steals
unterbrech => interrupt
zang => tong
panama => panama
gepackt => packed; compact
miliz => militsiya
aristotel => aristotle
klarstell => clarify
kling => ring; clink; clang
ungesund => unsound
iq => iq
josef => joseph
ersetz => supersede
kuba => cuba
detailliert => detailed; detail
griffith => griffith
hyster => hysterically
tomorrow => tomorrow
phosphor => phosphorus; phosphorous
part => part
defini => define; defines; determine
unverkauf => unmarketable
honig => honey
poli => polish
khan => khan; cham
luxemburg => luxembourg
funktionsfah => functioning; functional
scoot => scooter
appetit => appetite
brieftasch => briefcase
gestarkt => starchy
twelv => twelve
ramm => ram
streicht => strikes out
klemm => clamp
resultiert => results
hiermit => hereby; herewith; here
lino => lino
gurgelt => gargles; gurgles
bel => bel; decibel
deportiert => deports; deported
technologi => technology; technics
rennpferd => runner
six => six
cholesterin => cholesterol
dankt => thanks
marschi => march
verlernt => unlearns; unlearnt
dekolleté => decollete
goldig => golden; gold
rammt => rams
expandiert => expanded
losmach => detach
orientier => orientation; orienteering
schlamm => clay
bulgari => bulgaria
massachusett => massachusetts
dynam => dynamic; dynamicly
patricia => patricia
quintus => quintus
wundersam => wondrously
natrium => sodium
unangekundigt => unannounced
eingeschaltet => intercalary
konsistenz => consistency
kansas => kansas
che => che
exquisit => exquisite; exquisit; exquisitely
mobil => mobile; movable; moving; mobilized; moveable
schutteln => churn
impul => impulsion
oval => oval; ovally
flieht => flees
integri => integrate
begrabt => buries
timbuktu => timbuktu
jamaika => jamaica
flack => flicker; flare; flash
nerv => nark; nerve
erleichtert => lightens
sudostasi => southeast asia
chronisch => chronically
sirius => sirius
rog => roger
senk => sink; descend
grupp => groups
paradox => paradoxical; paradoxic; paradoxal; paradoxial; paradoxically
ro => ro
feststell => state
knurr => purr
rasend => rage; raging
opossum => possums
mitbring => bring
fand => found
bemerkt => remarked
absolut => absolute; absolutely
sonora => sonora
radioaktiv => radioactive; radioactively
leblos => lifeless; lifelessly
david => david
fantasi => fantasise; to fantasize; fantasize
blubb => bubble
kulturell => cultural; culturally; culture
setz => set; bet; sit
freund => friends
offiziell => official; officially; offical; official (off.)
kinderlos => kidless
notiert => noted; notes; noticed
verspruht => sprayed; sprays
rumpelstilzch => rumpelstiltskin
berlin => berlin; berliner
safran => saffron
gezwinkert => winked
crack => cracker
posiert => postures; posed; postured
frisch => fresh; freshly; brisk
errichtet => erects; erected
vorhersag => forecast; foretell; forebode; prophesy
habgier => avid
compton => compton
adam => adams
konsultiert => consults; consulted
armst => poorest
serviert => serves; served
kosmisch => cosmic; cosmical
predig => preach
automat => automatic; automatically; automated; automatical; oat; automaticly
siebt => seventh
rostig => rusty; rustily
gelandet => landed
parvati => parvati
einstweil => interim
gekomm => come
bracht => brought
tom => tom
regelt => regulates
marcel => marcel
hypnotisiert => hypnotized; hypnotizes
eingeb => enter
grell => shrill
moral => moral; morally
talon => talon
schwertfisch => swordfish
beatric => beatrice
durr => dry
mit => with
unberechenbar => unreckonable
geniert => generated
wovon => whereof
falscht => faked; falsified
trallert => trolls; trills
religios => more religious
unverwust => everlasting
beizeit => betimes
modifiziert => modifies; modified
sevilla => seville
weil => a while
hel => helen
kreischt => screeches
heizung => heating
wunsch => wish
dramat => dramatically
zwolft => twelfth
nonstop => nonstop; non-stop
schopft => scooped
bewach => watch; keep watch
marmor => marble
melk => milk
freilass => release
schien => shined
deppert => dopey
furz => fart
all => all
korall => coral red; coral
harmlos => more harmless
krishna => krishna
tr => tr
sprech => speak; express
reinig => cleaning
wundert => wondered
lob => lobe
vorweg => formerly
wilhelm => william
elimini => eliminate
gluht => glow; glows
verona => verona
radikal => radical; drastically; radically; cardinally
anna => anna; anne
filt => filter
nies => sneeze
borg => borrow
wladiwostok => vladivostok
korrigiert => corrected; corrects
diagramm => diagram
dialekt => dialect
har => harem
konservativ => conservatively
ida => ida
finanziell => financial; financially
ehrenwert => honest
nero => nero
pluto => pluto
beginn => begin
aktiv => more active
gesund => sound
bertha => bertha
kraul => crawl; do the crawl
nachfuhl => feel; to feel
kannibalismus => cannibalism
akt => act
irrelevant => irrelevant; irrelevantly
ups => oops
selbstgemacht => self-made; self made
ball => bang
overall => coveralls
gackert => cackles
popmus => pop
bohr => bore
belfast => belfast
pfusch => botch
kaukasus => caucasus
eingegeb => entered
riskant => riskier
uns => ours
interpretation => interpreting
rosmarin => rosemary
honduras => honduras
gesung => sang; sung
absurd => absurd; absurdly
profit => nonprofit
gruppi => group
tunis => tunis
lahm => lame
klarmach => clarify
fm => fm
funktioni => function
rustikal => rustic; rustically; rustic-style
tig => tig
foxtrott => foxtrot
venus => venus
mobiltelefon => mobile
seattl => seattle
zacharias => zachariah
starr => stare
salzburg => salzburg
kriminell => more criminal
ausflipp => flip
ignoriert => ignored
transportiert => transported
journalismus => journalism
organisation => organization
entwirft => contrives
mechan => mechanics
pessimist => pessimistic; pessimistically; defeatist
ubereifr => overzealous; overeager; overbusy
abenteu => adventurous
strikt => strictly; strict
fur => for
dinosauri => dinosaur; dinosaurs
uberfluss => superfluous; needless; superfluously
glas => glassy; glass; of glass
peking => beijing
eroffn => open
kolosseum => colosseum
halt => halt; last
entrustet => enraged; disgusted
schraub => screw
cat => caterer
gemeint => meant
kentucky => kentucky
floh => flea
pistazi => pistachio nut
expandi => expand
lyon => lyon; lyons
klapp => clapper
hab => have; have to
kuch => cook
pensioniert => pensioned
gegoogelt => googled
dikti => dictate
nig => niger
gnus => gnu
hoffnungslos => hopeless; hopelessly
genf => genevan
authent => authentic; authentical; authentically
spritz => spray; sprayer
uberschreib => overwrite; override; transcribe; overstrike
grins => grin; grinning
folgend => following
joseph => joseph
over => over
richtig => right
emery => emery
zivilisiert => civilized
groov => groove
stor => disturb
widerstand => withstood
ultraschall => ultrasound
schnappt => snaps
karl => charles
daphn => daphne
wascht => washes
latina => latina
berechn => reckon
blok => low
hess => hess
stapeln => stack
missverstand => misapprehended; misunderstood
guru => guru
ungehindert => unhindered
schmuggelt => smuggled
wandert => wanders
wickelt => wired
pinocchio => pinocchio
konfrontiert => confronts; confronted
phanomenal => phenomenal; phenomenally
achtzehn => eighteen; eightteen
namenlos => nameless; anonymous; namelessly
lacki => lacquer
anstatt => instead
abkuhl => abate
potential => potential
ordinar => ordinary
markiert => marked; marks
unterliegt => underlies
unregelmass => irregular
eingerichtet => constructed; instituted
opus => opus
kontext => context
orion => orion
konverti => convert
handball => prison handball
gordon => gordon
hiss => hoist
regiert => reigned
kopi => copy; copying
krabbelt => crawls; scrabbles
siames => Siamese; siamese
stampf => stomp; stamp; tramp; tamp
marmelad => marmalades
mallorca => majorca; mallorca
hallowe => halloween
kipp => tip; tilt; topple
komplikation => complication; complexity
leon => leon
kennedy => kennedy
ebb => ebbe
uberwaltigt => overcame; overmastered; overwhelmed
professionell => professional; professionally; professional-looking
funftel => fifth
einreis => enter
turn => turn
gros => gross
stamm => stem
programmi => program; programme; programming; computer programming
reich => richest
egozentr => egocentric; self-centred; self-centered; autocentric; egocentrically; egoist
dan => dane
untreu => untrue
ll => ll
mittel => middle
haha => haha; hehe
beschreib => describe
erot => erotica
ineffizient => inefficient
turkisch => Turkish; turkish; turk
emmy => emmy
out => out
nachos => nachos
marina => marina
nachtclub => night club; nightspot
autopilot => automatic pilot
johl => howl
vulkan => volcanically
hierhin => hither; here
erfund => unfounded
technisch => technicality
kanad => Canadian
funfzig => fifty
reserviert => reserved; reservedly; restrained
thraki => thrace
tunneln => to tunnel
falsch => falser; false
verleitet => deceived; deceives
eindamm => dam
recht => right; correct; straight
loswerd => lose
dunde => dundee
reduzi => reduce
pladi => plead; pleaded; pled; pled}
blink => blink; twinkle; wink; glint
meint => meant
jenny => jenny
brandenburg => brandenburg
januar => january
wass => waters
gestresst => stressed
kurbeln => turn
forsch => do research
aufgetret => appeared
witzig => witty; wittily
april => april
schmerz => ache
manipuli => manipulate
schind => skin
ausfull => fill
bann => banner
basier => basing
halloch => hello there
jordan => jordan
amusant => amusing; amusingly
freier => freer
fett => fat; fats; fatty
miranda => miranda
tan => tan
patch => patch
suspendi => suspend
paradi => paradise
portugies => portuguese
gefall => agreeable
irak => iraq
konvertiert => converted; converts
stormy => stormy
en => en
fallt => falls; fells
hung => hunger
main => main
paraguay => paraguay
marrakesch => marrakech; marrakesh
christin => christina; christine
hm => hmm; hm; mhm; hem; um
marty => marty
jura => jurassic; jura
phas => phase
high => high
halluzini => hallucinate
tink => tinker
zirkus => cirque
eingraviert => engraved
kiew => kiev
island => icelander
backstag => backstage
koko => koko
unrein => unclean; uncleanly; unfair
newcastl => newcastle
unterlieg => underlie
stress => distress
siebent => seventh
steinbock => steinbock (ibex)
abgebroch => aborted
schlank => scrawny
neulich => newly; now
hektisch => hectic; hectically
assimiliert => assimilated
gestreut => strewn
la => la
proteus => proteus
stein => stonen
nachbar => neighbor; neighbour
ath => athena
guerilla => guerrilla war; guerrilla warfare
schramm => scrape; scratch
sebastian => sebastian
information => piece of information
privat => private
imm => immense
stefani => stephanie
heulend => howling; hooting; bawling; wailing
revolutionar => revolutionary; in a revolutionary way
spenc => spencer
steil => steeper
einhalb => half
lesbisch => lesbian; Lesbian
iwf => imf
suggeriert => suggests; suggested
jubelt => jubilates
sediert => sedated
explodiert => explodes; exploded
sabbert => slavers; slobbers
verdresch => thresh
erfullt => fulfilled
russki => russki
fil => file
roll => roll; roll up; coil
niagara => niagara
einzigart => singular
endet => ended
ruhr => ruhr
kodiert => coded; codes
paar => pair
plump => clumsy
abel => abel
kratzt => scratched; scraped
belag => besiege; beleaguer
murrisch => churlish
wartend => waiting
boykotti => boycott; to boycot
aquivalent => equivalent
mexikan => Mexican; mexican; mexikan
vorwart => forward; onward; forwards; forth; onwards; forrader; forrard
erduld => endure
fond => fond
giraff => giraffe
akzepti => accept; accredit
chines => chinaman; chink
samson => samson
miet => let
unterschreibt => undersingns; underwrites
gehindert => hindered
inhaliert => inhales; inhaled
war => were
vertret => represent
metz => metz
jesu => jesu
praktisch => more practical
ubersteht => overcomes
enzyklopadi => cyclopaedia
subjektiv => subjective; subjectively; subjectivity; active; proactive; subject
wort => keyword
amusi => amuse
eve => eve
konstant => constant; constantly; consistent
karthago => carthage
jubeln => jubilate
uberhor => overhear
hypnotisi => hypnotize; to hypnotise; hypnotise
perspektiv => prospects
temporar => temporary; temporal; temporarily
winseln => whine
stickig => stifling; sticky
tokio => tokyo
gesteuert => steered
versklavt => enslaved; enslaves
piano => piano
ernst => earnest; earnestly
uberbewertet => overvalued; overvalues; overvalue
barsch => harsh
vollend => end
durf => dare; durst
faschist => fascistically
nepal => nepal
strapazi => strain
stoned => stoned
abitur => abitur
schab => scrape; scratch
ritus => rite
heidnisch => heathenish
madonna => madonna
angefullt => full
judas => judas
rekrutiert => recruited; recruits
marz => march
bask => basque
wat => what
greek => greek
firma => firm
interessanterweis => interestingly; interestingly enough
loyal => loyal; loyally
polin => pole
vegetation => vegetation
fair => fair; faire
brud => bruv
plural => plural
mango => mango
argentini => argentine; argentinean; argentineans; argentinian
juli => july
unvorhersehbar => unforeseeable
famos => famous
word => were
ah => uh
parzival => perceval; percival
finanziert => financed; finances
delegi => delegate
uberschrieb => overridden; overwritten
spirituell => spiritual; spiritually
codiert => coded; codes
hornis => hornet
verkrampf => cramp
rubbeln => rub; rub on
komma => comma
variant => version
reaktiviert => reactivates; reactivated
schwirr => whir; whirr
pupill => pupil (eye)
sara => sara
klingon => klingon
schier => sheer
jalta => yalta
stetig => steady; steadily
pet => peter
dubai => dubai
nordwest => northwestern; northwest; northwesterly; north-western; north-west
loui => louie
mari => mary
physisch => physical; physically; physikalisch
sup => super
gronland => greenland
pythagoras => pythagoras
assistiert => assists; assisted
licht => light; bright
gedampft => damped
act => act
sensibel => sensitive; sensible; sensory; sentient
gepresst => pressed
ubertroff => overshot
bb => bb
newton => newton
lawrenc => lawrence
symbolisi => symbolize; symbolise; symbol
fif => fife
konstantin => constantine
klettert => clambers
pascal => pascal
verletz => violate
gefahrd => hazard
zelebri => celebrate
streift => streaked; striped
schanghai => shanghai
hollisch => hellish; hellishly
rid => rider
unwissent => unwitting; unwittingly
no => no
informi => inform
shampoo => shampoo
organisi => organize; arrange; organise
platin => platinum
uberwind => overcome
kastriert => castrates; castrated
kittel => kittel
voreil => forwardly
elektromagnet => electromagnetically
echo => echo
akkurat => accurate; accurately
tunnel => tube
korrumpiert => corrupted; corrupt; corrupts
plastisch => plastically
autsch => ouch
schnuffeln => snuff; sniffle; snuffle
kingston => kingston
energ => energetic
verseh => serve
wenn => when
bigfoot => bigfoot
desorientiert => disoriented; disorientated
bitt => bitter; bitterly
fast => fast; fasting
argumenti => argue; argumentation
gekodert => decoyed
koln => cologne
tu => tu
neutral => neutral; neuter; neutrally; in a neutral way
allzu => all too
kontaminiert => contaminated
skalpiert => scalped; scalps
sirup => sirup
shining => shining
frachtschiff => freight ship
streut => strews
et => it
verfall => fall
schoss => shot
hupf => hop
brach => cracked
amphitryon => amphitryon
bleich => bleak
porto => oporto
ubereilt => overhasty
uberseh => overlook
anpflanz => plant
flanki => flank
jazzmus => jazz
gap => gap
rhein => rhine
gertrud => gertrude
knack => crack; crackle
ibiza => ibiza
roderick => roderick
niagarafall => niagara falls
beend => end
tratsch => tattle
fummeln => fumble
gestreift => stripy; streaky
welch => each; which
verteid => defend
beklag => bemoan
problemat => problematic; problematical; problematically
camelot => camelot
kabinett => cabinet; kabinett
kamp => kamp
tabu => taboo; tabu
sing => sing
knuddel => cuddly
olympia => olympia
maximal => maximal; maximum; maximally
hemlock => hemlock
stripteas => striptease
effektiv => effectively
para => para
schlaust => sliest
riskiert => risked
legal => legal; legally; legality
synchronisi => synchronize; synchronise; synchronise, sync
ungemut => uneasy
trainiert => trained
gewundert => wondered
minderwert => inferior
dresd => dresden
tahiti => tahiti
kapellmeist => kapellmeister
quiekt => squeaks
hob => hove
verfeinert => refined; refines
uberfullt => overfilled; overstuffs
zion => zion
interferenz => interference
argus => argus
cok => coke
gartn => garden; gardening
streun => strays
macho => machismo
ausland => outlander
sabel => camber
desinfiziert => disinfected; disinfects
mac => mace
jonathan => jonathan
lim => lime
variation => variation
insof => insofar; in so far
gewettet => betted
bestellt => bespeaks
ignorant => ignorant
kafka => kafka
synchronisiert => synchronizes; synchronised; synchronized
pharao => faro
inspiziert => inspected; inspects
elysium => elysium
steckt => stuck
age => age
a => a; an
oral => oral; orally
debakel => débâcle
hypothet => hypothetical; hypothetically
seitwart => sideways; sideward; sidewards
glory => glory
cod => code
uberbring => bring
nikolaus => nicholas; nicolas
kurios => curious
bereichert => enriches; enriched
pond => pond
gestartet => started
toronto => toronto
sed => sed
erinn => remind
tartaros => tartarus
methan => methane
uberreizt => overwrought; overbid; overexcited
erwarm => warm
knuddeln => cuddle
kalt => cold; curt
infrarot => infrared; infra-red
ohio => ohio
kalibri => calibrate; calibrating; calibration
hermet => hermetic; hermetical; hermetically
mischt => mingled
dokumentation => documentation
telefon => telefon
psychiatr => psychiatrically
auswert => assess
frei => free; freely
erklimm => climb
jaul => howl; yowl
aufgeh => bulge
fassad => facade
bill => bill
pingel => finical
schreien => scream; shriek
manif => manifest; manifesto
um => up
fortuna => fortuna
soft => soft
cent => center; centre
gelyncht => lynched
mammut => mammoth
nd => nd
diamant => diamond; diamantine
sorgenfrei => carefree; worry-free
kanalisi => canalise; canalize; channelling
serbi => serbia
anekdot => anecdote
kapitan => sea captain
geleast => leased
dublin => dublin
schal => shawl
erhasch => catch; snatch
wodka => vodka
georgia => georgia
down => down; downcast; low
madrid => madrid
zivilisation => civilization
quintessenz => quintessence
entflamm => inflame
touché => touché
geheult => howled
absorbi => absorb
marokko => morocco
famili => family
freihalt => treat
favoritin => favorite; favourite
rekruti => recruit; to recruit sb.
beijing => peking; beijing
irr => err
plausibel => plausible; feasible; plausibly
schockiert => shocked
bemerkbar => remarkably
sonnig => sunny
stolziert => stalked
muff => muff
michael => michael
macao => macau; macao
intravenos => intravenous; intravenously
kompakt => compact; compactly
josua => joshua
jesus => jesus
pieps => peep; pipe
kreuzweis => crosswise; crossways
sendet => sent
maskiert => masked
acht => eighth; eighths
stopf => stuffed
antwort => answer; accept; answering
filmt => filmed
miserabel => miserable
begluckt => lucky
unsympath => unsympathetic
rauscht => soughs
gedacht => thought
vietnam => vietnam; viet nam; nam
sling => sling
thailand => kingdom of thailand; thailand
ulkig => joking
erinnert => remindered
vorausseh => foresee
ottawa => ottawa
bern => bernese
castro => castro
verpackt => packs
unattraktiv => unattractive; unappealing
offent => open; overt
gedreht => veered
theb => thebes
klebt => cleaves
gratuli => congratulate; congratulations
col => col
geatmet => breathed
kontrast => contrast
kracht => cracked
dick => thick; thickly
quiek => squeak
usbekistan => uzbekistan; republic of uzbekistan
piep => cheep; peep
tony => tony
uberfahrt => overruns
gluh => glow
hinfort => henceforth; henceforward
cholera => cholera
innovativ => innovative
sonnenlicht => daylight
dekoriert => decorates; decorated
thor => thor
tombston => tombstone
quell => well; swell
w => w
lill => lille
madagaskar => madagascar
unterernahrt => undernourished; underfed; underfedly
untyp => untypical; untypically
cujo => cujo
unerreichbar => unreachable; unapproachable
send => send
probl => problem; trouble
ritual => ritual
stranguliert => strangles; strangled
flamm => flame
geographi => geography
ingw => ginger
frank => franconia; franks
tough => tough
rem => rem
theatral => theatrical; theatric
ballist => ballistically
mitt => amidst; mid; middle
assoziiert => associate; associated
vorhergesagt => foretelled; forecast
achill => achilles
fecht => fight
innerst => inmost; innermost
armband => armband
benenn => mention
heilbar => healable
pc => pc
tafel => tableau
saboti => sabotage
gelenk => agilely
hundertmal => a hundred times
green => green
abseil => abseil
blokt => bleats
gesunk => sunk
reflekti => reflect; be reflected
ddr => ddr
jehova => jehovah
unterhaltsam => entertaining
spitz => spiky
beliz => belize
holland => Netherlands; Hollandic
andernfall => alternatively
ubertragt => overtops
scheu => eschew
mekka => mecca
wild => wild; wildly
juan => juan
weitgeh => wide
erring => earn
untertauch => go underground
junior => junior
gebund => bound
patriot => patriotic; patriotically
lobotomi => lobotomy
spekuliert => speculated
neurolog => neurological
umprogrammiert => reprogrammed
bonnet => bonnet
genet => genetical
unzufried => dissatisfied; unsatisfied
portsmouth => portsmouth
naiv => naively
skandinavi => scandinavia
mannheim => mannheim
greenwich => greenwich
melanchol => melancholic; melancholy
ungestort => undisturbed
charleston => charleston
boa => whoa
kombini => combine; join; combinate
uberschreit => overstep; overrun; overshoot; overstay
als => as
sofia => sofia
zweimal => twice; times
mississippi => mississippi
sizilian => sicilian
uberwund => overcome
abdank => abdicate
monopoly => monopoly
macbeth => macbeth
heli => heli
mylord => milord
prot => protest
tschetscheni => chechnya
interessi => am interested in
raubt => rapes; robs
action => action
christus => christ; christus
staat => state
bangkok => bangkok
rehabiliti => rehabilitate
pfluckt => picks
styl => style
boston => boston
ungar => Hungarian; hungarian; magyar
grimm => grim
selbstbewusst => self-aware
moira => moira
spang => spring
zickzack => zigzag
heul => howl; bawl; hoot
ammoniak => ammonia
wilmington => wilmington
unverbess => hopeless
barcelona => barcelona
japan => japan
anstarr => stare
cos => cos
anred => address
monika => monica
imposant => imposing
ostrog => estrogenic
thanksgiving => thanksgiving
ti => ti
reichstag => reichstag
googeln => google; Google
neufundland => newfoundland
junki => junkie
ag => ag
jersey => jersey
vulkani => vulcan; vulcans
kalibriert => calibrates; calibrated
gerichtet => directed; oriented; riveted; straightened
seitlich => sidelong
asi => asia
polit => politically
soziologi => sociology; social science
pan => pan
ptolemaios => ptolemy
platziert => placed
jamaikan => jamaican
pharmazeut => pharmaceutically
dora => dora
zerhack => hack
aktivi => activate; actuate
thomas => thomas
background => background
matthaus => matthew
pruft => perused
heult => howled
migran => migraine
kart => card
wuff => woof; ruff
ok => okay; ok; okey
stu => stu
basel => basel; basle
amazonas => amazon
uberarbeitet => overwrought; overworked; over-worked; overhauled
lov => love
hindi => hindi
fluchtig => fleeting; fugitive
auspack => unpack
jugend => juvenile; juvenilely
grundet => founds; grounds
wick => wick
quadrant => quadrant
tragischerweis => tragically
korp => corporeal; corporal
comput => computer
spaltet => splits
wertlos => worthless; worthlessly
split => split
bow => bow
elizabeth => elizabeth
now => now
aqua => aqua; aria
brugg => bruges
sag => say
burgund => burgundian; burgundy
scharp => scarf
greas => grease
nant => nantes
hannov => hanover
grotesk => grotesque; grotesquely; gross
co => co
skifahr => ski
blaubart => bluebeard
exponentiell => exponential; exponentially
behindert => hindered
belgrad => belgrade
galoppiert => galloped
schlitzt => slits
agamemnon => agamemnon
vista => vista
stempel => stamper
klatscht => claps
dies => these
baseball => ball; hardball
wart => were
europa => europe; europa
independenc => independent
hinbring => bring; to bring
fa => fa; fah
exekutiv => executive branch
verstand => understanded; understood
karat => carat
stammig => strong; stumpy
su => su
nervos => nervously
constantin => constantine
produzi => produce
glouc => gloucester
reichlich => rich
dicht => tight
stripp => strip
montiert => mounted
lili => lili
identitat => identity
stimuli => stimulate; stir up
geklammert => clamped
gewartet => waited
deponi => deposit; depose; deposite
kastri => castrate
roosevelt => roosevelt
beast => beast
engagi => engage
streckt => stretched
montgomery => montgomery
ein => best in
verschreib => prescribe; inscribe
best => best
andock => dock; to dock
eskortiert => escorted
normal => more normal
easy => easy
abbrech => abort; break
frigid => frigid
agent => agent
gregory => gregory
walhalla => valhalla; walhalla
ever => ever
registri => register
chevron => chevron
magi => magier
lagert => lairs
odysseus => odysseus; ulysses
aufricht => straight
plus => plus
halbi => halve
darwin => darwin
cann => cannes
bestimm => destine
oberst => topmost; uppermost
unterst => lowest; undermost; lowermost
em => em
feminin => feminine; female; effeminate
gekostet => cost
astronom => astronomical; astronomic; astronomically
frontal => frontal; frontally
mayas => mayas
stilvoll => stylish; stylishly
misstraut => distrusts; mistrusts; mistrusted
aufhang => hang; suspend; augment
handvoll => handful
sim => sim
wirbelt => swirls; twirls; whirls
kabul => kabul
frivol => frivolous; frivolously
andreas => andrew
ecuador => ecuador
fokussi => focus
schaufeln => shovel
ruckwart => backwards; backward; rearward; rearwards
dink => dink
verbarrikadi => barricade
implantiert => implanted; implants
ticktack => tick-tock
deprimi => depress
osman => ottoman
kardiologi => cardiology
musst => must
urin => urine
cash => cash
afrika => africa
stereo => stereo
wahrend => whereas; when
grenobl => grenoble
ml => ml
akzeptiert => accepted
hydraul => hydraulic
latino => latin; latino
zorro => zorro
go => go
neutralisi => neutralise; neutralize
monsignor => monsignor
tadellos => blameless
nigeria => nigeria
stabilisiert => stabilised; stabilized
gepaart => paired
nektar => nectar
vorgewarnt => forewarned
australi => australia
demonstri => demonstrate
ahoi => ahoy
zhou => zhou
kuckuck => cuckoo
sony => sony
spezialisi => specialize; specialise
odessa => odessa
zirp => chirp; chirr
kanaan => canaan
herbei => here
fruchtbar => fruitful
blindling => blindly; blindfold
anford => ask for
gerostet => roasted
reap => reaper
sterilisiert => sterilizes; sterilised; sterilises; sterilized
sav => sava
lock => cluck
sekund => sec
divin => divine
erganz => reach
andromeda => andromeda
nordse => north sea
alternativ => alternate
kooperation => cooperation
io => io
schroff => gruff
minimal => minimal
verhungert => died of hunger; dies of hunger
prothes => prosthesis
antwortet => answers; retorts
unaufmerksam => unalert
destabilisiert => destabilised; destabilized
rundum => round; roundly
unbegrundet => unfounded
transformation => transformation; transform
urini => urinate
doctor => doctor
mask => masker
pullman => pullman
istanbul => istanbul
volkslied => volkslied
klickt => clicks
m => m
bolognes => bolognese
wahrnehm => awareness
vorerst => for now; for the present
theori => theory
export => export
poseidon => poseidon
adieu => adieu
risiko => risk
beelzebub => beelzebub
armageddon => armageddon
katharina => catherine
atlant => atlantic
castor => castor
medusa => medusa
ordnung => order
spreiz => spread
nageln => nail
marschiert => marches; marched
malaysia => malaysia
grabt => grubs
altmod => outmoded
orpheus => orpheus
el => el
robin => robin
klass => class; classroom
faszinier => fascinating; fascinatingly
nos => nose
irrational => irrational; irrationally; irrationality
poesi => poetry
mon => mon
toleri => tolerate
total => total; totally
defensiv => defensive; defensively
scharlatan => charlatan
frittiert => fried
wimmert => whimpers
poliert => polished; polishes
marguerit => marguerite
vesta => vesta
frankenstein => frankenstein
pflicht => office
leuchtend => lucid
met => metre
odin => odin
lax => lax; laxly
produktion => fabrication; production
indiskret => indiscreet; indiscreetly
hf => hf
monst => monstrosity
hierbei => hereby; here
truck => trucker
satteln => saddle
alias => alias
ungarn => hungary; hungarians
muschi => coochie
champagn => champagne
gebunkert => bunkered
warm => warm; warm up; get warm
lachend => laughing
fischt => fishes
hammert => hammerd
barfrau => barmaid
verwundet => wounded
tres => tres
panth => panther
bisexuell => bisexual; ambisexual; ambosexual
strassburg => strasbourg
duplikat => duplication
monatelang => monthslong
spartan => spartan
kuri => cure; care
darin => therein; herein
funky => funky
hoh => high
begier => eager
hebraisch => Hebraic; Jewish; hebraic; hebrew
hallo => hello; hallo
hip => hip
strateg => strategic
entsend => send; stand
holprig => halting
tschechisch => czech
ambitioniert => ambitious
morbid => morbid
wund => wonder
intelligenz => intelligence
giuliano => julian
germani => germania
tb => tb
unterholz => understorey
bohm => bohemia
handbrems => handbreak
schnuffelt => snuffles; snuffs
modisch => modish; voguish
schlupf => slip
python => python
wo => who; when
pseudonym => pseudonymous; pseudonymously
grimmig => grim; grimly
soso => so-so
katalysator => catalysis
kant => cant
schocki => shock; rock; shake
fc => fc
danisch => Danish; danish
ruman => Rumanian; romanian; rumanian
schnatt => chatter
toxikolog => toxicologically
milch => milk
hisbollah => hezbollah; hizbullah
vehement => vehement; vehemently
oha => whoa; oh
verstreu => strew
unpunkt => unpunctual
drak => drake
beschmiert => besmears
intensiv => intensive; intense; intensely; intensively
pinkeln => piddle
tub => tube
manuell => manual; manually
hecheln => heckle; hatchel
britisch => British; british; britannic
feil => file; forfeit
zirka => circa
unbefleckt => undefiled
seel => soul
arabi => arabia; araby
seh => see
bestial => bestial; brutish; beastly; brutal
transaktion => operation
ipod => ipod
afrikan => African; african
knopf => knot
regim => regimen
grossart => great
mechanismus => mechanism; mechanics
mary => mary
ausdehn => widen
walt => walter
unentschuldbar => unexcusable
pantomim => pantomime
schock => to shock
muss => must
ziti => cite
entlock => extract
kg => kg
neurot => neurotic; neurotically
krah => crow
kooperiert => cooperated; cooperates
schmuggeln => smuggle; smuggling
servic => serve
wolf => wolf
lar => lar
suit => suit
brilliant => bright; brilliant
imiti => imitate
sergeant => sergeant
arnold => arnold
amsterdam => amsterdam
kontinuum => continuum
mein => mine; me
jogg => jog
dezemb => december
acapulco => acapulco
devon => devonian; devon
aphrodit => aphrodite
arktis => arctic
hungert => hungers
abgeg => aligned
russland => russia
dunkl => duskier
steril => sterile; infertile; sterilely; unfertile
ubernacht => stay overnight; overnight
geblendet => blinded
betort => besotted
traumat => traumatic; traumatically
lagos => lagos
bad => bathe; bath; baden
fang => bag
eitel => conceited
gehofft => hoped
wegkomm => walk
ungebund => unbound
dezent => discreet; decent
euphor => euphoric
antik => ancient; antique; antiquely
reserv => reserves
rout => to route
aggressiv => more aggressive
richard => richard
artefakt => artifact
addi => add; add up
refrain => refrain
nipp => sip
handeln => handle; haggle
capot => capote
regi => reign
musikal => more musical
monopol => monopole
mojito => mojito
louisiana => louisiana
platt => flat
autorisi => authorize; authorise
athlet => athletic; athletically
gerieb => grinded
informativ => informative; informatively
ketchup => catchup
solch => such
studiert => studied
unbemerkt => unseen
schachmatt => checkmate; stalemate
komisch => comical; comic
aufstell => install
objekt => object; objekt
mist => mist
servi => serve; serve out; serve up
haar => lose hair
begrundet => founded
streik => strike; struck; stricken; stricken}
ungeseh => unsighted; unseen
erfull => fulfill; perform; fill
geschloss => close
spektakular => spectacular
spindel => spindle; mandrel
yama => yama
bella => bella
daddy => daddy
fliesst => flows
knatt => chatter
lernt => learns
franklin => franklin
arrogant => more arrogant
fund => fund
mexiko => mexico
potentiell => potential; potentially
finn => finn
stach => stuck
fliessend => fluent
bullshit => bullshit
elia => elijah
unterstreicht => underlines; underscores
tourismus => tourism
sie => they; she; them; he
besing => sing
dunkeln => darken; dusk
indirekt => indirect; indirectly
supermarkt => supermarket
uberanstreng => overexert; overstrain; overwork
exkommuniziert => excommunicated
produktiv => more productive
thessaloniki => salonika; thessaloniki
sportlich => sporty; sporting; sportingly; sportsmanlike; sports
gefuhlt => felt
uberrannt => overrun
kapstadt => cape town
atzend => acrid
mais => mealie
verbittert => bitter; embittered; embitters
howl => howl
pflanzt => plants
coop => cooper
normalerweis => normally; normal
lamb => lamb
field => field
nat => nat
trink => drink
unangemeldet => unannounced
phantasi => fantasy
aufgeduns => puffed up
autorisiert => authorized; authorised; authorizes; authored; authorises
bonn => bonn
purpur => purple; purpure; mercury
nag => gnaw
kasachstan => kazakhstan
schmatz => smack; champ
reform => reform
lokalisi => localize; locate; localise; lokalise
stick => to stitch
will => will
und => and
kommunizi => communicate; commune; comunicate
sparsam => sparing; sparingly; spare
lasch => flaccid
todschick => chic
grundlos => groundless
grundwass => groundwater
imag => image
degeneriert => degenerate; degenerately; degenerates; degenerated
matthias => matthew
psychot => psychotic
unklar => unclear
garantiert => warranted; guaranted; guaranteed; guarants
mariann => marianne
wes => whose
intakt => intact
raub => rob; rape
dafur => for; favor; favour
inoperabel => inoperable
mim => mime
emotional => emotional; sentimental; emotionally; emotive
zensiert => censored
chlor => chlorine
parma => parma
unrechtmass => illegitimate
trauma => trauma
exklusiv => exclusive; exclusively
untermau => underpin; to undergird
mathemat => mathematical; mathematic; mathematically; math
lima => lima
padua => padua
geklung => clang; clank; clink
sumatra => sumatra
unternahm => undertook
iris => iris; irises
lag => lay
das => it
elast => elastic
zittert => jittered
lukrativ => lucrative; remunerative; lucratively
gestoppt => stopped
erblind => go blind; become blind
kommandi => command; be in command
hurra => hooray; hurrah; hurray
gumbo => gumbo
parkinson => parkinson's
somalia => somalia
klirrt => chinks; clangs; clanks; clashes
gefloh => fled
bahamas => bahamas; the bahamas
provozi => provoke; be provocative
in => in; into; on
appelli => appeal
wohingeg => while
voran => forward; forth; forwards
playa => playa
bei => beside
dreieinhalb => three and a half
anspring => to spring at
fusioni => fuse
dolor => dolores
vorhersehbar => foreseeable
dokumenti => document; documenting
floor => floor
lokalisiert => localizes; localised; localises; localized; located; locates
tret => tread
steu => steer
heilung => healing
vietcong => vietcong
pfluck => pick; pluck
bestehl => steal
jok => joker
entwed => either
komposition => composing; construction
kapital => capital; capitally; fatal
sexualitat => sexuality
konserviert => conserved; conserves; preserved
schreit => strut
miau => miaow; miaou
vorderst => foremost; forward
run => run
obszon => obscene; obscenely
schnief => snivel
sudan => sudan
einquartiert => quartered
platzi => place; plant
sternenbasis => starbase
truffel => truffle
heroin => hero
ruckstand => backward
heart => hearts
ninja => ninja
uriniert => urinates; urinated
philipp => philip
konfisziert => confiscated; confiscates
saphir => sapphire
wagenlad => wagonload
kontra => contra
unfreund => unfriendly; unkind
parallel => parallel
tipptopp => tiptop; tip; tip-top; top
ba => ba
fuhlt => felt
produkt => product
wehrmacht => wehrmacht
himalaya => himalayas
mala => mala
panisch => panic-stricken; panicky; panic; panicly; panicked
brutal => brutal; brutish; cruel; brutally; bestial; brute
chest => chester
fohl => foal
uberrollt => overruns; overrun
uberrenn => overrun; overwhelm
bastard => bombard
rugby => rugby football
oftmal => often; ofttimes
support => support
blutig => bleeding
lila => lilac
fliegt => flies
stattlich => stately
lots => lure
trinity => trinity
laila => leila
leck => nice
kombi => combo
jordani => jordan
unbeabsichtigt => undesignedly
zundet => kindles
ten => ten
restauriert => restores; restored
film => film
gaga => gaga
speziell => special; especially; specially; especial; specific
angetrunk => half drunk
utah => utah
volum => volume
spruh => spray; sparkle; spritz; spout; spring
lola => lola
bereut => regretted
inspizi => inspect
fallend => falling
zweitaus => two thousand
besag => say
tuchtig => doughty
krakau => cracow; krakow
lebend => living; live; life; lively
uberzog => overdrawn; overblown; covered; overcast; overlayed
leto => leto
hindert => hindered
dilemma => dilemma
inderin => indian
alexand => alexander
installi => install; instal
operi => operate
sy => sy
davenport => davenport
charl => charles
duo => duet
schottland => scotland
qualitat => quality
gerechnet => reckoned
mam => mam
diplomat => diplomatic; diplomatically
kett => fetter
intuition => intuition
stopft => stuffs
inspirier => inspiring; inspirational; inspiriting
sarkast => sarcastic; sarcastically; snarky
vereitelt => defeated
beschwort => besought
vorlaut => forward
spatest => latest
sterilisi => sterilize; to sterilise; sterilise
glamouros => glamorous; glamourous
investi => invest
augusta => augusta
posi => pose; posture
sticht => stings; sticks
lauwarm => lukewarm
sieh => see
modeln => model; modeling
bliss => bliss
ars => arsenic
undenkbar => unthinkable; unthinkably
ismael => ishmael
creed => creed
abschreib => transcribe
reflexion => reflection
gerry => gerry
anonym => anonymous; anonym; anonymously; anon; anon.
matsumoto => matsumoto
help => help
normandi => normandy
taff => taff
bitch => bitch
telepath => telepathically
elb => elbe
messag => message
mutig => gutsier
genug => be enough
liverpool => liverpool
kreuzig => crucify
darcy => darcy
duck => duck
softi => softie
zweig => twigs
quasi => quasi
schneid => shear
torchwood => torchwood
stempeln => stamp
labil => labile
wein => whiney; whiny
atlantis => atlantis
raptor => raptor
geliefert => delivered
erbring => bring
pers => persian
eingebettet => interbedded
johann => john
kaliforni => california
herzog => herzog
injizi => inject
nervig => nerved
gefund => found; funds
fehlerfrei => errorfree; error-free
milan => milan
spons => sponsor
stottert => splutters; stammers; stutters
ar => ar
manisch => manic; maniac; manically
miss => miss; lack miss
fotografi => photograph; take a photograph
cran => crane
hotel => hostel
umstand => circumstantial
eingebuchtet => indented
trat => trod
jewel => jewel
sass => sat
kuwait => kuwait
genom => genoms
radio => radio
hieran => here
existent => existent; extant; existing; in existence
vi => vi
farsi => farsi
betreff => bear
attacki => attack
rannt => ran
pausi => pause
belagert => beleaguered; beleaguers
unordent => unorderly
maxwell => maxwell
schnupf => snuff; sniff
stillsteh => stagnate
dosis => dose
markus => mark
unsagbar => unspeakable; unspeakably
respekti => respect
komplett => complete; completely
jon => jones
ausschwarm => swarm
piss => piss
operation => operation
schnattert => chatters
strampeln => struggle
geflirtet => flirted; gallivanted
pflanz => plant; place; lay
heran => here
herod => herod
adjektiv => adjective
garanti => guarantee; warrant
gips => gypsum
bayou => bayou
popular => popular
dini => dine
sabb => slobber
goa => goa
hupt => hoots
st => st
unhygien => unhygienic
finanzi => finance
gibraltar => gibraltar
plattmach => flatten
humanoid => humanoid; humanlike
hochstperson => in person; in-person
obduktion => obduction
brussel => brussels
endlos => endless; endlessly
mikrowell => microwave
halleluja => hallelujah; alleluia; halleluja
hinfall => invalid
bi => bi
lexington => lexington
erlern => learn
dad => dad
stemm => stem
trott => trotter
kollabiert => collapsed
orienti => orient; orientate
markt => market place
furchterreg => frightening
wie => like; when
hl => hl
knarrt => jars
sibiri => siberia
kongo => congo
begonn => begun
erstell => erect
guy => guy
gratuliert => congratulates; congratulated
einleg => inlay
anbring => bring
azur => azure
ausrott => stamp out; uproot
bourgeois => bourgeois
schnupp => snuff
ofen => oven
gaza => gaza
padophil => paedophiles
blendend => blinding; blind
uberhol => overtake; overhaul
fantasiert => fantasised; fantasized
weltbank => world bank
salpet => salpeter
owen => owen
labrador => labrador
bier => beer
warschau => warsaw
eintret => enter; enlist; eventuate
unterhielt => entertained
charlott => charlotte
projektion => projection; projecting
singend => singing
edward => edward
boxt => boxes
klammert => clamps
akupunktur => acupuncture; acupressure
mithelf => help
unentschied => undecided
jongli => juggle
verfrachtet => freighted
detoniert => detonated
nee => nope
ungewollt => unmeant
saftig => sappily; sappy
hochgrad => high-grade
randvoll => brimfull
exekutiert => executed
grac => grace
viertel => quarter
zitiert => cited
schmal => small
doof => goofy; fool
russ => russian
katastrophal => catastrophic; disastrous; catastrophically; disastrously; cataclysmal; catastrophical
unterzeichnet => undersigned; undersigns
chen => chen
tatowier => tattoo
behaart => hairy; haired
aufblas => upblow
verrott => rot; ferment
apoll => apollo
namlich => namely
columbus => columbus
amman => amman
formiert => forms up; formed up
abaddon => abaddon
manifestiert => manifested; manifests
maverick => maverick
angela => angela
vom => from
versend => send
rosett => rosette
grin => grins
que => que
arkansas => arkansas
rottweil => rottweilers
kosch => kosher
psychologi => psychology
molekular => molecularly
lektor => lector
hatch => hatch
umgeschrieb => described
knackt => cracks
normann => norsemen
kill => kill
judaa => judea
einpflanz => implant; plant
instabil => unstable; instable; unstably; instably
aussend => send
theseus => theseus
montpelli => montpellier
identifiziert => identified; identifies; he identifies
gerald => gerald
karpf => carp
aussag => say
zigarett => cigaret
beraubt => bereft; bereaves; robs; bereaved
heinrich => henry; heinrich
erst => first; 1st; earliest
palazzo => palazzo
mum => mum
maya => maya; mayan
missionar => missioner
oh => oh; ah
pfui => poo
abkomm => come
uberstand => overcame; overcome
brasilian => brazilian
palm => palm
graf => graph
stasi => stasi
casanova => casanova
zinn => tin
klee => clovers
klingeln => jingle
sexist => sexist
salzig => salty; salt; salted; saltily; saline
der => her
sesam => sesame; sesame seed
uberschreitet => oversteps
atlanta => atlanta
schrie => cried
torso => human torso
tragisch => tragically
jerusal => jerusalem
handicap => handicap
bagdad => bagdad; baghdad
peak => peak
tempelritt => templar; templars
rontg => roentgen
stinkig => stinking; stink
architekt => architect
uberbot => overbid
houston => houston
extermini => exterminate
luftdicht => airtight; air tight; air-tight
brems => break
zerfall => fall
mandschurei => manchuria
stotternd => stuttering; spluttering; stammering; stutteringly
verkompliziert => complicated; complicates
leipzig => leipzig
fuzzy => fuzzy
regular => regular; regularly
ls => ls
devonshir => devonshire
gebar => bear
kastration => castration
sudwart => southward; southwards
applaudiert => applauds; applauded
southampton => southampton
ubertreibt => overdoes
philadelphia => philadelphia; philly
lokal => local; locally; topical
ubergeh => overlook; merge
anubis => anubis
natali => natalia; natalie
einpark => park
varii => vary; variegate
datiert => dated
rosig => rosy; rose
spani => spaniard; spaniards
cox => cox
philippin => philippines
hannibal => hannibal
pladiert => pleaded
trianguli => triangulate
nelson => nelson
mol => mole
apach => apache
shuttl => shuttle
ausstreck => stretch
unscharf => unsharp
gill => gill
bemess => assess
tendiert => tended; tends; trended
krachz => crackle
auslad => unload; offload
jerry => jerry
unverandert => unchanged; unvaried
unterkuhlt => undercooled
casablanca => casablanca
schwell => swell
camp => camp
minneapolis => minneapolis
firm => confirm
zerstor => destroy
kritisi => criticize; criticise
uberhitzt => overheated; overheats; superheated
impotenz => impotency
diskrediti => discredit
kranz => garland; corona
quicklebend => quick
interview => interview
rapp => rap
energi => energy
schrott => scrap
es => ess
broadway => broadway
ash => ash
yeoman => yeoman
spiritus => spiritus
khmer => khmer
kontrolli => control
moritz => maurice
drift => drift
neidisch => enviously
spross => prong
catch => catch
hilton => hilton
okonomi => economy
juju => juju
pullov => pullover
c => c
passabel => passable
bali => bali
goldfisch => goldfish
lateinamerika => latin america
nona => nona
barbados => barbados
ank => anker
ramadan => ramadan
kompetent => competent; competently
rebekka => rebecca
diszipliniert => disciplined; disciplines
reflektiert => reflective; reflected; reflects; rejected
anfert => manufacture
indi => india
siebzehn => seventeen
geplundert => plundered
patrick => patrick
zurich => zurich
theres => teresa
ptolemaus => ptolemy
ubertret => overcome; overstep
opposition => opposition
geschrubbt => scrubbed
unfehlbar => infallible; infallibly; unfailing
brodeln => boil
gelad => reload
exakt => exact; exactly
wrestl => wrestler
williamsburg => williamsburg
siegel => seal
behammert => hammered
goldfing => goldfinger
versink => sink; sunk
kapiert => caught
extravagant => extravagant; extravagantly
rolf => rolf
abtreib => abort
oder => or
armeni => armenian; armenians
reagi => react
hindus => hindus
zentn => centner
beowulf => beowulf
prapariert => prepared
samarit => samaritan
pulsi => pulsate; pulse
regelmass => regular; regularly
retriev => retriever
sowi => too
balkon => balcony
sezi => dissect
bewalt => beat
kompromitti => compromise
sportl => sportspeople
spezialisiert => specialised; specialized
di => di
otto => otto
portugal => portugal
menelaos => menelaus
taliban => taleban; taliban
kantin => cantina
jd => jd
kuban => cuban
intro => intro
bernhard => bernard
tiberius => tiberius
eintrag => enter
reg => regen
informiert => informed; informs
chupacabra => chupacabra
effizienz => efficiency
adolf => adolf
degradiert => degrades; degraded
achteinhalb => eight and a half
leviathan => leviathan
toulous => toulouse
geisha => geisha girl
fiel => fell
hoffent => hopefully
jakob => jacob
klub => club
kollabi => collapse
abenteuerlust => adventurous
hierh => here; hither
aurora => aurora
dominant => dominant; dominantly; predominant
versaill => versailles
zeus => zeus
eliminiert => eliminates; eliminated
rosa => rose; rosy; roseate; roses
einst => erst
schlurf => slurp
martin => martin
zehntel => tenth
montenegro => montenegro
majestat => majestic; majestically; being majestic
picknick => to picnic; picnic
derweil => meanwhile
funktionstucht => functional
zhao => zhao
infiltriert => infiltrated; infiltrates
haifa => haifa
drollig => droll
terrass => terrace
uberfordert => overcharges; overcharged; overexerted; overstrained; overtaxed; overwhelmed; overworked
garstig => nasty; nastily
breton => breton
lobst => lobster
balthasar => balthazar
clay => clay
tennesse => tennessee
herzlich => heartily; heartfelt
connecticut => connecticut
masch => mascle
wasserdicht => watertight; water-tight
jaguar => jag
terrorisiert => terrorizes; terrorised; terrorized
unkooperativ => uncooperative
doktor => doctor
soo => soo
zertrampelt => trampled; tramples
lawton => lawton
alban => albanian
publik => public
dolc => dolce
backgammon => backgammon
kapseln => encapsulate; caps
knien => kneel; kneel down; kneeling; knelt; knelt}
kommenti => comment; comment on; commentate
jos => jos
bambus => bamboo
newport => newport
motorboot => powerboat
harry => harry
abba => abba
tanzch => dance
anlehn => lean
pk => pk
sch => sch; shh; shhh
rapid => rapidly; rapid
laos => lao; laos
besicht => visit
cy => cy
schmier => smear
texan => texan; texans
radon => radon
pentagon => the pentagon
fossil => fossil; fossilized
uberford => overcharge; overburden; overextend; overtax; to overexert; overstrain
doodl => doodle
masturbiert => masturbates; masturbated
zogernd => lingering
sprint => sprint
ce => cee
katapultiert => catapulted; catapults
geendet => ended
aufsag => say
rausch => rush
jurist => juridical; juristic; juridic; juristical
kippt => topples
passiv => passive; passively; inactive
sea => sea
spekuli => speculate
kroati => croatia
selbstgefall => self-satisfied
surpris => surprise
unkonventionell => unconventional; unconventionally
heterosexuell => heterosexual
dominiert => dominates; dominated
jim => jim
californication => californication
kapitalismus => capitalism
tyrannisiert => tyrannizes
jammert => yammers; laments
pink => pink
nelly => nelly
z => z
cardiff => cardiff
stabilitat => stability
lucas => lucas
aperitif => appetiser
gereist => peregrinated
ithaka => ithaca
ubervorsicht => overcautious
richtet => straightens
absorbiert => absorbs; absorbed
prompt => prompt; promptly
nostalg => nostalgic; nostalgically
taxi => taxi cab
basilikum => basil
pumpt => pumps
soda => soda ash
surreal => surreal; surrealistic
abrupt => abrupt; abruptly
explizit => explicit; explicitly
nicht => naught; nought
erin => erin
manila => manila
schwedisch => Swedish; swedish
grillt => grills
konfiszi => confiscate
bitcoin => bitcoin
rekonstrui => reconstruct
spezial => special
monseigneur => monseigneur
tang => tangier
winselt => whines
beauregard => beauregard
wolltet => would
aufwarm => warm
flirt => flirt; flit; flutter
allerlieb => alluring
livr => livre
trabi => trabant
niederland => netherlands
pennsylvania => pennsylvania
ursula => ursula
mali => mali
taktvoll => tactful; tactfully
tartar => tartar
kompani => company
zwei => two; twain
unzivilisiert => uncivilized; uncivilised; uncivilizedly
fixier => fixation
entfalt => unfold
regeneration => regeneration
kassiert => cashed
brigadi => brigadier
shun => shun
definition => determination
slam => slam
alarmi => alarm; alert
syri => syria
herein => come in; here
saluti => salute
max => max
hiob => job
multipl => multiple
colombo => colombo
gantry => gantry
spital => spital
fuhl => feel; reek
tunesi => tunisia
gomorrha => gomorrha
dax => dax
zynisch => cynical; cynic; cynically
schieb => shift
potsdam => potsdam
vancouv => vancouver
charisma => charism
marsch => marshland
streng => stringently
erblindet => blind; blinded
amputiert => amputates; amputated
york => york
screen => screen
stolp => stumble
entfall => fall
salamanca => salamanca
beep => beep
landschaft => landscape
junk => junker
kontraproduktiv => counterproductive; counter-productive; counterproductively
durst => thirst
steinhart => stonehard
einkomm => income
malaria => malaria
levi => levi
verkrampft => cramped
o => oh; o
ln => ln
identifizi => identify
record => record
ray => ray
schimmert => glimmers; shimmers
balanc => balance
formation => formation
ideologi => ideology
netz => netting
unprofessionell => unprofessional; nonprofessional
badet => bathes
uberwieg => overwhelming
amour => amour
weissrussland => belorussia
i => i
vorsing => sing; to sing for
oslo => oslo
lunar => lunar
implanti => implant
nova => nova
grafik => graphics
spin => spin
gerockt => rocked
clev => clever
stimuliert => stimulates; stimulated
alaska => alaska
repariert => repaired
geziemt => befit
hinweg => away
magnus => magnus
ablad => unload; offload
maria => mary
wackelt => waggles; wags
self => self
sho => sho
brasili => brazil
zombi => zombi
chemi => chemistry
bandbreit => band
uberschritt => overstepped
again => again
bristol => bristol
schnaps => snaps
desinfizi => disinfect
bombardiert => bombarded; bombed
sol => sol; so
gutheiss => authorize
vorherbestimmt => predestined
cassius => cassius
nicaragua => nicaragua
heut => now
ka => kay
intelligent => more intelligent
unterstreich => underline; underscore
fun => fun
douglas => douglas
handwerk => handiwork
existi => exist; existence
xerx => xerxes
aneurysma => aneurysm
hing => hung
unablass => ceaseless
jt => jt
her => here; hither
infizi => infect; inflame
meng => mingle
groll => to roll
blocki => block; blockade; lock; block off
bundel => bundle
pyjama => pajama
fury => fury
knot => knot; connect
rost => rust
grummeln => grumble
zulu => zulu
cob => cob
philosoph => philosophical
tracht => ache
mysterios => mysterious; mysteriously; misterious
hang => hang; dangle; hang down; hung; hang over
bordeaux => bordeaux
diagnos => diagnosis
mikros => mics
kriecht => creeps; cringes
soldat => soldier
geschor => shorn
neust => newest
reduziert => reduced; reduces
washington => washington
niveau => niveau
injiziert => injected
ungleich => unlike
amor => amor
legendar => legendary
y => y
uberspielt => overacts; overacted; overplayed
los => loose
fritt => to frit
melon => melon
mill => miller
komponiert => composes; composed
edo => edo
recherchi => research; recherche
zentral => center; centrally
genauso => also
council => council
fan => fan
anomali => anomaly
interviewt => interviews; interviewed
les => lecture; see; peruse
verlang => prolong; delay
werth => worth
brust => boast; bluster
spring => spring
caesar => caesar
signora => signora
seri => string; set
bottom => bottom
smith => smith
demokrat => democratic; democratically; democrat
allmacht => almighty; almightily
gab => gave
zweieinhalb => two and a half
punktlich => punctual; punctually
schaufelt => shovels
kleidet => clothes
herbert => herbert
kichert => snickers; titters
bett => bed
soviel => so many
gummi => gum
gigant => gigantic; giant; gargantuan; titanic
kurzsicht => short-sighted; nearsighted; shortsighted; near sighted; near-sighted; shortsightedly
steck => stick; tuck
so => so
punk => punk
con => con
ed => ed
ubel => evil
luk => luke
subjekt => subject
festlich => festive; festal; festally; festively
spontan => spontaneous; spontaneously
mahdi => mahdi
sem => shem
aufwach => awake
assisti => assist
flirtet => flirts
pittsburgh => pittsburgh
salvador => salvador
vermiet => let let
gewicht => weight
recyceln => recycle; cycle
idiot => idiotically
senior => senior
zubring => bring
wundervoll => wonderful; wonderfully
alzheim => alzheimer's
aufrecht => upright; erect; uprightly; direct
brosch => broach
gesendet => sent
louis => louis
lebenslang => life sentence; lifelong
biolog => biologically
material => material
stephan => stephen
konsumi => consume; consuming
por => por
distanzi => distance oneself; distance; outdistance
dekadent => decadent; decadently
temperatur => temperature
has => hare
auflist => list
vord => forward; former
akzent => accent
debatti => debate
turbin => turbine
therapeut => therapeutic; therapeutical; therapeutically
gespart => spared
pension => pension; pensione
verkabeln => cable
angola => angola
faschismus => fascism
saturday => saturday
weitersag => write to
medina => medina
medea => medea
schwank => sway; shake; swing
gluhend => glowing
liv => live
beginnt => begins
unbekannt => unbeknownst
texas => texas
venezuela => venezuela
brav => brave
toy => toy
kochkun => cooking
uberflut => overflow; overrun
rom => roemer
tanzerin => dancer
zukomm => become; come
quart => quarter
befurwortet => supported; supports
nisch => niche
realist => more realistic
bomb => bomb; bombing
unprakt => impractical; unpractical; nonpractical; unpractically
aluminium => aluminium
begeb => betaken
korkenzieh => cork-screw
jota => jota
schmor => simmer
oberflach => surface
muscheln => mussel
spanisch => Spanish; spanish; Hispanic; hispanic
grandios => grandiose; grand; grandiosely
ausle => vacuate
mitnehm => kidnap
branch => branch
gymnasium => gymnasium
angeln => angle; angles
sattig => saturation
cd => cd
brunett => brunette; brunet
entbind => untie
beschreibt => describes
inakzeptabel => unacceptable; inacceptable; unacceptably
finnland => finland
barfuss => barefoot
kabel => cable
city => the city
schwarm => swarm
positiv => more positive
fungi => function
axel => axel
lockert => limbers; loosens
interessant => most interesting
ty => ty
momentan => momentary; momentarily
abart => aberrant
pelz => pelt
benedict => benedict
victoria => victoria
sedan => sedan
anhalt => halt
warn => warner
wackeln => waggle; wiggle; wag
sarah => sarah
unmoral => immoral; immorally; unethical; amoral
christentum => christendom
marki => mark
verfracht => freight
greift => grips
deprimiert => depressed
indisch => Indian; indian; Indic; indic
eventuell => potential
windsor => windsor
gefilmt => been filming; filmed
selbstsich => self-assured; self-reliant
wlan => wlan
evakui => evacuate
drin => in
schwedin => swede
systemat => systematic; systematically; systematical
privilegiert => privileged
diktiert => dictates; dictated
grosst => greatest; most
metatron => metatron
ordn => order
spriess => sprout
scheiss => shit
unvorbereitet => unpremeditated
rothaar => red-haired; red hair
wasch => wash; wash up
bridg => bridge
spruht => sprays
extrahi => extract
richt => straighten
ethnisch => ethnical
rassist => racist; racialist
schloss => clasp
uberfall => overdue
vermind => decrement
reaktionar => reactionary
rekonstruiert => reconstructed; reconstructs
videospiel => videogame
inspiriert => inspirational; inspired; inspires; inspirited
gedenkt => thinks
werb => woo
einfall => invade
familiar => familiar; familial; family
hereinleg => deceive
windig => windy; windily
redlich => real
kick => kick
begunst => benefit
lud => laded; loaded
mosaik => mosaics
verpack => pack
viva => viva
mos => moses
ach => ah
feuerball => thunderball
gesucht => sought
unverantwort => unwarrantable; unwarrantably
exklusivbericht => exclusive
reykjav => reykjavík
flussig => fluider
eigenhand => single-handedly; single-handed
nummeriert => numbered
rudi => rudy
goteborg => goteborg; gothenburg
lust => lustful; lusty
frustriert => frustrated; frustrates
regn => rain
jungfrau => jungfrau
kupplung => coupling
unglucklicherweis => unluckily
portrat => portraiture; portrayal
kolumbian => colombian
florida => florida
gr => gr
gesteckt => stuck
jalousi => louvre
uberflog => overflown
taktlos => tactless; untactful; tactlessly
hameln => hamelin
geregelt => well-regulated
interpretiert => interpreted; interprets
kostet => costs; tastes
deck => deck
wollt => would
rass => race
abzieh => abate
sin => sin
konkret => concrete; concretely
sentimental => sentimental
kost => cost
unkompliziert => uncomplicated
tran => tear
schema => schema; scheme
wc => wc
schlachtet => slaughters
funktion => function
richtigstell => right
gala => gala
jericho => jericho
standhalt => stand firm
barack => barn
wirbeln => whirl; swirl; twirl
importiert => imported; imports
temperamentvoll => temperamental; temperamentally
geschwindelt => swindled
geboxt => boxed
problemlos => problem-free; trouble-free; unproblematic
blind => blind; blindly; blank; blindfold
association => association
translation => translation
oregano => greek oregano
fax => fax
zurecht => aright
mach => mach
providenc => providence
platoon => platoon
nenn => mention
today => today
epilepsi => epilepsy
onkologi => oncology
vermiss => miss
gestattet => granted; permitted
wash => wash
palastina => palestine
train => trainer
vorschreib => prescribe
neuseeland => new zealand
pollux => pollux
losbind => unbind
austricks => trick
schott => scot
krabbeln => crawl; scrabble; scramble
sadist => sadistically
kantones => Cantonese; cantonese
klimp => clink
bring => bring
formt => formed
x => x
dreiundzwanz => three-and-twenty
quitti => quit
ese => ese
maryland => maryland
klappert => clatters
postiert => posted
do => do; doh
rechn => reckon
ausgeschied => egested
gedankt => given thanks; said thanks
queer => queer
bravo => bravo
westeuropa => western europe
short => short
schwan => swan
pragmat => pragmatic; pragmatical; practical; pragmatically
bundeln => bunch; bundle
liby => libya
hamilton => hamilton
sowjetunion => soviet union
homosexuell => homosexual; homosexually
gregor => gregory
merced => mercedes
adoption => adoption
holosuit => holosuite
zivil => civil; civilian; civic
quakt => quacks
gentry => gentry
hast => hast; have
honolulu => honolulu
italienerin => italian
jack => jack
nachtwacht => nightwatchman
dirigi => direct
untot => undead
hundert => hundreds; hundredths
piranhas => piranha
majestic => majestic
befurcht => affright
don => don
habt => have
huckepack => pickaback
small => small
komtess => countess
sylv => sylvester
involvi => involve
kolossal => colossal; colossally
alkm => alcmene
vietnamkrieg => vietnam war
arrangi => arrange; array
erricht => erect
hunderttaus => hundred thousand
jennif => jennifer
walz => wallow
knirsch => crunch; gnash
thai => thai
you => you
papi => paper
sah => saw
initii => initiate; institute
schwing => swing
strukturiert => structured; textured; structures
piazza => plaza
heiz => heat
bettelt => begged
lassig => easygoing
aktivitat => activity
georg => george
crown => crown
aladin => aladdin
joe => joe
geantwortet => answered; retorted
beklagt => bemoans
danemark => denmark
russin => russian
mutiert => mutated
jet => jet
befrei => free; relieve
schwankt => sways
sprang => sprang
symbolisiert => symbolizes; symbolised; symbolises; symbolized; symbolled; symbols
pst => hist
twitt => tweet; twitter
schnippisch => snappish; snappishly
kalbfleisch => calf meat
gehweg => footway
depressiv => depressive; depressively; depressed
sand => sanders
misstrau => mistrust
schwindet => dwindles
halbtag => half-time
radius => radius
unerwartet => unexpected; unexpectedly
presto => presto
analogi => analog
was => what
lern => learn; larn
sink => sink; sunk
chapel => chapel
birmingham => birmingham
oe => oe
havanna => havana
reinhold => reginald
uberqu => overcome
futt => fatten
bolivar => bolivar
stressig => stressful
hatt => had
telegrafi => telegraph; telegram
bongo => bongo
troja => troy
freisetz => free
gerollt => rolled
sensationell => sensational
untaug => unfit; inept; unapt
kuriert => cured; nursed
unbeantwortet => unanswered; unacknowledged
emili => emily
datenbank => databanks
areal => areal
behandelt => handled
diagnostiziert => diagnoses; diagnosed
operiert => operated
mexikanerin => mexican
sperr => suspend
unbehag => uneasy
terminal => terminal; final
manag => manage
rational => rational; reasonable; rationale; rationally
stehl => steal
lassi => lassie
verfilmt => been filming; filmed
kapituliert => capitulates; capitulated
sokrat => socrates
leaf => leaf
betaubt => benumbs; numbs
rachel => rachel
neutron => neutron
zitt => jitter
frédéric => frederick
student => student
maxim => axiom
halbweg => halfway; midway; half-way; partway
aufwuhl => affect
blend => blind
tricks => trick
attraktiv => attractive; attractively; attracting
organisiert => organized; organizes; organised; organises
benahm => behaved
walk => walker
tee => tea; tee
shanghai => shanghai
dehydriert => dehydrated; dehydrates
deformiert => deformed
reservoir => water reservoirs
modifizi => modify
wird => will
q => q
mahl => mill
nuckeln => suck
mobilisi => mobilise; mobilize; galvanize
frankfurt => frankfurt
uberdreht => overreved; overtightened; overtwisted; overwound
universal => universal; general; over-all
rap => rapping
laura => laura
latein => latin
kidnapp => kidnap
beduin => bedouin
nr => nr
peru => peru
plasma => plasm; plasma
captain => captain
sardini => sardinia
brr => brr
zerr => tear
uberheb => overbearing; overweening
packung => package; parcel
eingefugt => inset
mg => mg
lennox => lennox
eskorti => escort
mordet => murders
monro => monroe
aufroll => roll; furl; enrol; unroll
sorry => sorry
langfrist => long-term; long; long term; long-range; long-ranging; long-run
sicherst => safest; securest; surest
bam => bam
biet => bid
canterbury => canterbury
analys => analyzing
laurel => laurel
oscar => oscar
verbiet => forbid; interdict
haddock => haddock
enoch => enoch
innehalt => interrupt
reaktion => reactionary
festgestellt => detected
aberde => aberdeen
exhumi => exhume
talent => talent
chor => choir
magisch => magic; magical; magically; magicly
quetsch => squish; squash
flatt => flutter; flap; flacker
jodelt => yodels
wem => whom
prud => prudish; prim; prude; prudishly
staatlich => state; statist
magazin => magazine
aushand => hand
willig => willing; willed; willingly
sexy => sexy; foxy
einwerf => insert
waterloo => waterloo
maschinenraum => machine room
uberzieh => overdraw; overlay; overrun
deaktiviert => deactivated; deactivates
ski => skiing
entlang => along
helios => helios
tageslicht => daylight; day light; sunlight
drau => drava
instinktiv => instinctive; instinctively; instinctual; intuitively; intuitive
manhattan => manhattan
beschmutz => besmear
bolivi => bolivia
bombardi => bombard; bomb
diana => diana
detroit => detroit
noti => note; notice
mail => e-mail; email; mail
vorherseh => foresee; forecast
wickeln => reel
u => u
eintauch => instruct
italien => Italian; italian
sur => sura
rollt => rolled
aufklar => clear; make clear
mystery => mystery
basis => basis
weinbrand => brandy
buddha => buddha
dov => dover
tapet => paper
neo => neo
korruption => corruption
rumpeln => rumble
dobson => dobsonian
olympic => olympic
analysiert => analyzed; analyzes; analysed; analyses
apollon => apollo
bingo => bingo
asgard => asgard
flasch => flask
orang => orange; orange tree; oranges
hastig => hasty; hastily
eduard => edward
an => on; at; in
stabilisi => stabilize; stabilise; establish
bik => bike
zweihundert => two hundred
fruhest => soonest; earliest
verrostet => rusted; corroded
malta => malta
oxford => oxford
bag => bag
hellicht => bright
keinesweg => no way; in no way; not in any way
torkeln => totter; reel; to careen
re => re
bath => bath
wedeln => wedel
original => original; orginal; orignal
domini => dominate; predominate
wendigo => wendigo
vor => before; from; forward; for
gefickt => fucked
konzession => concession
offnet => opened
harsch => harsh; harshly
general => general officer
voilà => voilà
murmelti => marmots
signalisiert => signaled; signalised; signalises; signalized; signalizes; signalled; signals
geschwung => swung
voll => full
toleranz => tolerance
getankt => tanked
simpl => simple
lausann => lausanne
paprika => paprika
einstudiert => studied
noch => nor
grusel => gruesome
geologi => geology
om => om
klassifiziert => classified; classifies; classed; classes
atom => atom; atomy
generell => general; generally
hor => hear
pump => pump
mittelalt => medieval
kardinal => cardinal
tibet => tibet
spul => spool
frier => freeze
verfickt => motherfucking
bemerk => remark
horn => horn; cornet
glitch => glitch
schlafend => latent
unterschreib => underwrite; undersign; endorse; subscribe
separat => separate; separately
massiv => massier; more massive
verhalt => behave
existiert => exists; existed
campo => campo
land => land
kommerziell => commercial; commercially; commercial |com.
merlin => merlin
dringend => urgent; exigent
zucht => educate
synchron => synchronous; synchronic; synchron; synchronously; synchronal
auffull => fill; refill; to backfill
physikal => physical; physically; physic; physisch
schatt => shade
trend => trend
personal => personal
korean => Korean; korean
janus => janus
trac => trace
scylla => scylla
gay => gay
visi => vizard
man => human
umleit => deflect
vision => vision
konn => can
glasur => glaze; glazing
unterwasch => underthings
sic => sic
welk => wilt
dus => dash
buch => beechen
bonbon => bon-bon
motiviert => motivated; motived; motivates
haiti => haiti
parkplatz => park
geweint => wept
prasenti => present; represent
limitiert => limited
iron => ironic; ironical; ironicly
suspendiert => suspends; suspended
architektur => architecture; architectural
monat => monthly
wirk => work
gepasst => passed
intim => intimate
ablief => deliver
vampir => vamp
dumpf => dull
hatschi => atchoo
gespruht => sprayed
tora => torah
von => of
erfrisch => refresh
einbring => bring
monogam => monogamous; monogamously
interessierst => are interested in
cambridg => cambridge
nippel => nipple
konzipiert => conceived
praktizi => practise; practice
albert => albert
dyk => dyke; dike
udssr => ussr
kooperi => cooperate; co-operate
deal => deal
verhut => avert
tokyo => tokyo
entwirr => unsnarl
starrt => stares
chisum => chisum
banan => banana; banana tree
hard => hard
eingeschloss => enclosed
mentor => tutor
normalisiert => normalized; normalizes; normalised
navigi => navigate
selbstsucht => selfish; selfishly; self-serving; self-seeking
per => per
verhung => be hungry
verderbt => perverse
getestet => tested
psycholog => psychologically
gaff => gape; gawk
tropisch => tropically
allwiss => all-knowing; all knowing
masturbi => masturbate
sierra => sierra
luxurios => luxurious; luxuriant; luxuriously; luxury
prinzipiell => principled; in principle; on principle
wofur => what for; wherefore
salomon => solomon
eingeh => enter
sima => sima
aktivist => activism
agn => agnes
versprech => expect
bedenkt => bethinks
intellektuell => intellectual; intelligent; intellectually
prominent => prominent; prominently; eminent
unzerstorbar => undestroyable
gorillas => gorilla
amusiert => amused; amuses
schrumpf => shrink
sarajevo => sarajevo
untertrieb => understated
gemied => avoided; scorned; evaded
happy => happy
medaill => medallion
unterhalb => underneath; under
isoli => isolate
aufpepp => to pep up
schmeck => smack
worin => wherein
munz => mint
unwurd => unworthy; unworthily
korfu => corfu
francis => francis
next => next
foul => foul
komm => come; cum; come from
kommunist => communistically
geparkt => parked
uberschattet => overshadows; overshadowed
tas => tasers
koma => coma
haarig => hairy; haired; hairily
uppsala => uppsala
cali => cali
kaputt => kaput
alexandria => alexandria
therapi => therapy
zwink => wink; blink; twinkle
russisch => Russian; russian; russ
mammi => mummy
fokus => focus
skorpion => scorpion; scorpiones
portland => portland
reinwasch => whitewash
maggi => maggie
etabli => establish
uberschuttet => overwhelmed
stinkt => stinks
gelernt => learnt
annulli => annul; nullify
illustriert => illustrated
brom => bromine
irisch => Irish; irish
shiva => shiva
eton => eton
suboptimal => suboptimal; optimal
halbieren => halve
sicherste => safest; securest; surest
indianisch => Indian; indian
palästina => palestine
dünner => skinnier; thinner
kassie => cassia
caterer => caterer
kompanie => company
kompromittieren => compromise
schmutzige => smuttily
fungieren => function
geflogen => flown
drake => drake
losmachen => loosen
rotten => rotten
besprechen => bespeak
schleifen => sharpen
monitor => monitor
servierte => served
oftmals => often; ofttimes
pierrot => pierrot
unterliegen => underlie
kam => came
älter => elder; elderly; older
höllisch => hellish; hellishly
piepsen => peep; pipe
unterste => undermost
überwachung => tracing
brauen => brew
dreckiger => muckier; dirtier; grubbier
schwirren => whirr
vorausgesehen => foreseen
gestunken => stunk; stink
sauer => sour
raffinierte => refined
identische => identically
wüsten => waste
ungarisch => Hungarian; hungarian
objektive => objectively
kämpfte => combated
schneller => speedier
pjöngjang => pyongyang
amazon => amazon
kommodore => commodore
schärfste => sharpest
ausquetschen => squeeze
dundee => dundee
ptolemäus => ptolemy
murren => murmur; mutter
genetischen => genetically
maxime => axiom
marmelade => marmalades
paarweise => pairwise; pair; paired
porter => porter
einpflanzen => implant
praktizieren => practise; practice
sonniger => sunnier
mischen => mingle
frigide => frigid
ballistische => ballistically
anschwellen => swell
zelebrieren => celebrate
lehnte => leaned; leant
franken => franconia; franks
heften => fasten
interessanterweise => interestingly; interestingly enough
schatten => shade
welken => wither; wilt
krächzen => crackle
grün => green
argentinier => argentine; argentinean; argentineans; argentinian
joggen => jog
füllen => fill; fill up; fills
innings => innings
meiste => most
seriös => serious
weniger => fewer; lesser; under
vorderster => foremost
später => later; after
äußerster => utter
exklusive => excluding; exclusive; exclusive of
tödlicher => deadlier
kichern => snicker; titter
analyse => analyzing
freitags => Fridays
persien => persia; persian
früher => earlier; former
rose => rosa
hysterische => hysterical
korkenzieher => cork-screw
salzburger => salzburg
waten => wade
dezember => december
elementare => elementally; elementary
folgen => follow
bizarre => bizarre
charismatisch => charismatic; charming
georgien => georgia
verschlafen => oversleep
onkologie => oncology
behandelte => handled
fetter => fatter
hoffnungsvolle => hopefully
papieren => paper; papery; papier-
liberal => liberal; liberally
olympiade => olympiad; olympics
straßburg => strasbourg
ironisch => ironic; ironical; ironically; ironicly
ersticken => stifle
missbrauchen => misuse
fade => tame
massiver => massier; more massive
qualität => quality
eingetreten => entered
gig => gig
stopfst => stuffed
störe => sturgeon
komplizierte => complicated
grill => grill; grille
blutete => bled
verboten => forbidden; verboten
twist => twist
kombinieren => combine; combinate
schmidt => schmidt
brigitte => bridget
hinfällig => invalid
plante => planned
rest => rest
stufe => storey
arabien => arabia; araby
stottern => stutter; stammer; splutter; sputter
dynamische => dynamic; dynamicly
ästhetik => aesthetics
hierfür => therefore; therefor
standard => standard
also => so
kritische => critically
ketten => fetter
masche => mascle
größtes => greatest
scheiße => shit
traumatisch => traumatic; traumatically
kreativ => creative; constructive; creatively
englisch => English; angelic; angelical; english
sehe => see
fälschlich => falsely
pepper => pepper
kommunizieren => communicate; commune; comunicate
stahlen => stole
scheibe => wheel; screen
vulkanische => volcanically
angetrunken => drunken
süßen => sweeten
hut => hat; hut
schmatzen => smack
adonis => adonis
schniefen => sniffle; snivel
schizophrenie => schizophrenia
glamourös => glamorous; glamourous
schwanken => shake
kreuzigen => crucify
klebte => cleaved
lange => long; a long time; lengthy; long time
kleben => cleave
passierte => passed
jennifer => jennifer
prahlen => parade
brüllen => bellow; holler
coke => coke
container => container
loyale => loyally
glätten => flatten
makler => factor
kratzte => scratched
garantieren => guarantee
brüten => breed
checken => check
teller => teller
organisierte => organised; organized
norweger => norwegian
harken => rake
privilegierte => privileged
entflammen => inflame
vorwarnen => forewarn
elektrischer => electrical
oswald => oswald
jener => yonder
collier => collier
sagen => say
wackelig => waggly
schrieb => scribed
demütigen => demean; despise
piepen => beep; peep
erbringen => bring
gegründet => grounded
schwindeln => swindle
irritierend => irritating
realistisch => realistic; realistically; realisticly
rechtes => right
lauern => lurk
reflex => reflection; reflexion
abnormal => abnormal; anomalous; abnormous; abnormally; anormal
standhalten => stand firm
desertiert => deserted
heilen => heal
müsst => must
räuber => robber; marauder
pflanzen => plant; place
mobilisiert => mobilizes; mobilised; mobilises; mobilized
bieten => bid; present
bolivien => bolivia
einwerfen => insert; interject
tube => tube
jugendliche => juvenilely
informierte => informed
magier => magier
trick => wrinkle
glitzern => glitter; glisten
alice => alice
belgien => belgium
absorbieren => absorb
hebräisch => Hebraic; Jewish; hebraic; hebrew
reflektieren => reflect; be reflected
formulieren => formulate
rauen => roughen
bereuen => repent; rue; be penitent
sinken => sink; sunk
eingießen => ingrain
investiere => invest
studieren => study
turbine => turbine
interessieren => interest; intrigue; be interested in
lieben => like
skelett => skeleton
widerfahren => befallen
ende => end
zypern => cyprus
rapide => rapidly; rapid
beschwört => besought
plündern => plunder
lynchen => lynch; lynching
strategische => strategic
senken => sink; descend
sure => sura
finanzieren => finance
weiser => wiser
europäisch => european
explodierte => exploded
vermarkten => market
adelaide => adelaide
suchte => quested; sought
buchen => beechen
kreieren => create
hinauszögern => linger
hocken => hunker
gesunken => sunk; sunken
wachst => waxes
schöpft => scoops
einfacher => easier
bank => sandbank
allerliebst => alluring
golfen => golf
konsultieren => consult
minsk => minsk
fanatisch => fanatical; fanatic; fanatically; frenetic
kongressabgeordnete => congresswoman
aushalten => sustain
unter => under; underneath
ostwärts => eastwards
gärtnern => garden
geschnüffelt => sniffed; snuffed
destabilisieren => destabilize; destabilise
werfen => heave
strukturelle => structurally; texturally
innerste => inmost; innermost
hässlich => unstylish
klammern => clamp
idiotische => idiotically
südwestlich => southwestern; southwesterly; south western; south-western; southwest; south-west
beige => beige
streiken => strike; struck; stricken; stricken}
judäa => judea
anderes => another; another one; otherwise
jedermanns => everyones
lüstern => lustful; lusty
stopfte => stuffed
mutter => mater
ajax => ajax
entdecken => detected; undeck
tinker => tinker
selbstgerecht => self-righteous; self righteous
anders => another
unpersönlich => impersonal; impersonally
eintreten => enter; eventuate
automatisch => automatic; automatically; automated; automatical; automaticly
landete => landed
hysterisch => hysterical; hysteric; hysterically
weiter => further
cc => cc:
pflücken => pluck
immunität => immunity
rebellieren => rebel
münchen => munich
emotionale => emotional
schützen => screen
predator => predator
howdy => howdy
bessern => better
voraussehen => foresee
bike => bike
dänisch => Danish; danish
strenge => stringently
alarmieren => alarm
biochemie => biochemistry
wärmer => warmer
zentrales => centrically
bitterlich => bitterly; bitter
fußnote => footer; note
leviten => levite; levites
rudolf => rudolph
ergriffen => stricken; gripped
freiburg => freiburg; fribourg
erhoffen => hope
kantor => chanter
frustrierend => frustrating; frustratingly
albanisch => Albanian; albanian
binden => bind; band; bundle
ließ => let
aufrollen => roll; unroll
agnes => agnes
linker => sinister
pflückt => picks
elegante => elegant
schwindelig => bewildering
vorhersehen => foresee
karton => cardboard; card
hello => hello
abgewartet => awaited
synchronisieren => synchronize; synchronise; synchronise, sync
mönch => mönch
qualmen => fume
dexter => dexter
william => william
salutieren => salute
luxuriös => luxurious; luxuriant; luxuriously; luxury
dürfen => dare
rasten => rest
leichteste => lightest
vegetarisch => vegetarian
infizierte => infected
steif => stiff; stiffly; strain
reiner => cleaner
kreditwürdig => creditworthy; credible
korrekt => correct; correctly; honest
verstopfte => constipated
verladen => laded
rechnen => reckon
spezifizieren => specify
sexualität => sexuality
flehte => pleaded
rebellisch => rebellious; rebelliously; rebel
bedrängt => throngs
typen => types
rider => rider
psychiatrische => psychiatrically
unaufrichtig => unfaithful
unterschätzt => underrated; underestimated; underestimates; underrates; undervalues; underappreciated; undervalued
wiener => viennese
grauer => grayer; greyer
litauen => lithuania
quadrat => quadrate; square; quad
illustrierte => illustrated
übergewichtig => overweight
überrannt => overrun
prügeln => cudgel
metamorphose => metamorphosis
elektronische => electronically
hierher => here; hither
exterminieren => exterminate
formell => formal; formally
belehren => enlighten
stemmen => stem
eingreifen => intervene
heller => clearer; heller
analogie => analog
verheilen => be healed
hier => here
hase => hare
dynamisch => dynamic; dynamically; dymanic
angelassen => annealed
karte => card
beraten => deliberate; debate
wehte => wafted
gewesen => been
exportieren => export
wachturm => watch-tower
selten => seldom
rauben => rape
langfristig => long-dated; long dated; long-range; long-ranging; long-run
streicher => strider
fischen => fish; fishing
beladen => loaded; lade; burden; laden
schärpe => scarf
maggie => maggie
dime => dime
bunkern => to bunker
stefanie => stephanie
genfer => genevan
visuell => visual; visually; visualisation; visualization
boxen => box
mörderische => murderously
härteste => hardest
ritzen => itch
geschmolzen => molten
zäher => tougher
kontaktieren => contact
silber => silver
voneinander => of one another
prüfen => prove
enthusiastisch => enthusiastic; enthusiastically
rhea => rhea
lebhafter => livelier
gemolken => milked
bestimmte => destined; constituted
gehangen => hanged
triple => treble
gestohlen => stolen; rustled
erkranken => sicken
moralisch => moral; morally
striptease => striptease
zeugen => beget
denker => thinker
alexander => alexander
tanger => tangier
appellieren => appeal
metaphorisch => metaphorical; metaphoric; metaphorically
methodisch => methodical; methodic; methodically; methodicly; methodological
cleverer => cleverer
bolognese => bolognese
höhle => pothole
fakultät => faculty
siebte => seventh; sieved; sifted
stillen => suckle
nervösen => nervy
schwimmen => swim; swimming
daten => date; data
gao => gao
nachher => later; after
private => private
banane => banana; banana tree
therese => teresa
kiffen => kif
historische => historical; historical map
zuschreiben => ascribe
kaltherzig => cold-hearted; coldhearted
videospiele => video game
positionen => positions
aufwachen => awake; awaken; waken
tapete => paper
streichen => stroke; strike
fassade => facade
suits => suit
esther => esther
glücklichste => luckiest
exhumieren => exhume
zerkratzen => scratch
ficken => fuck; fucking
arroganter => more arrogant
braten => bake
rekonstruieren => reconstruct
assimilation => assimilation
kommen => come
champagne => champagne
bretagne => brittany; bretagne
originell => original; originally
demokratie => democracy
rezitieren => recite
anspringen => spring upon; to spring at
stocken => stick; choke
anstarren => stare
margarete => margaret
homosexuelle => homosexually
überanstrengt => overstrains
mitbringen => bring
schule => school
wettete => betted
abchecken => check; to check
für => for
blamieren => blame
hand => handball
singapur => singapore
setzte => set
imitieren => imitate
schmelzen => smelt; scramble; melted
auffinden => find; refind
muster => master
abkommen => come
sarazenen => saracen
addieren => add together
versailles => versailles
romantische => romanesque
bemerkte => detected; remarked
fördern => further; foster
überfordern => overburden
tirol => tyrol; tirol
unsympathisch => unsympathetic
fester => firmer; tighter
nordsee => north sea
handbremse => handbreak
dialyse => dialysis
texten => text
vorhergesehen => foreseen
ansehen => see
suspekt => suspect; suspicious
faszinierend => fascinating; fascinatingly
zwingend => stringent
streifen => streak; stripe
thrakien => thrace
schalten => change
botanik => botany
mittlerweile => meanwhile
volumen => volume
adams => adams
spalten => split; separate
cabe => cabe
befragte => interrogated
grenoble => grenoble
solaris => solaris
spezialisieren => specialize; specialise
auswärts => outwards
auseinander => asunder
twelve => twelve
cäsar => caesar
herkommen => come
merkur => mercury
doppelgänger => doppelgangers; doppelgängers
strategisch => strategic; strategically; strategical; strategic location
unglücklich => unlucky; unluckily
ungesehen => unseen
primitive => primitiv; primitive
lime => lime
pissen => piss
posen => pose
surprise => surprise
springen => spring
spreizen => spread
syracuse => syracuse
fünfzehn => fifteen
befallen => befall
dieselbe => herself; himself
maine => maine
debattieren => debate
richtlinie => outline
barfuß => barefoot
mörderisch => murderous; murder
hypothetisch => hypothetical; hypothetic; hypothetically
positiver => more positive
frecher => saucier
psychologie => psychology
vandalismus => vandalism
papier => paper
mächtig => mighty; mightily
unzufrieden => unsatisfied
spritzte => spattered
straffen => tauten; strain
autorisierte => authorised; authorized
ankommen => come
verwirren => bewilder
repräsentiert => represented; represents
anthropologie => anthropology
digital => digital; digitally; digit
gelber => yellower
leber => liver
kolumbien => colombia
polen => poland; poles
mikrowellen => microwave
eher => rather; earlier; better
kidnappen => kidnap
feierte => feted
fällt => falls; fells
grade => grade
abbringen => wring
babysitten => babysit; baby-sit
vorwärts => forward; forwards; forth; onwards; forrard
kommuniziert => communes; communicated; communicates
verhalten => behave
erdulden => endure
festigen => fasten
grinst => grins
komitee => committee
fixieren => fixate; fasten
wolle => wool
multiplizieren => multiply; multiplication
reaper => reaper
sang => sang
chinesisch => Chinese; chinese
projizieren => project
verwüstet => wasted; wastes
synthetisch => synthetic; synthetical; synthetically
fürchten => frighten
bäh => bah
nordwestlich => northwestern; northwest; northwesterly; north-western; north-west
shoppen => shop; go shopping; shoppen
amerikanisch => American; american; American coffee
profitiert => profits; profited
behinderte => hindered
methode => mode
beneide => envy
wundern => wonder
überschrieben => overridden; overwritten; transcribed
prüde => prudish; prude
unpünktlich => unpunctual
willst => will
kapitulieren => capitulate
technik => technology; technique
untergräbt => undermines
schrillen => shrill
erklingen => ring
retter => redeemer
sendete => sent
familie => family
kooperieren => cooperate; co-operate
sirene => siren
lebendiger => livelier
hallöchen => hello there
deuten => portend
berichtigen => right; straighten
stabilisieren => stabilize; stabilise; establish
schwärmen => swarm
heftiger => testier
blökt => bleats
rüde => rude; rudely
trainieren => train
zoomen => zoom
wichtiger => bigger; weightier
synaptische => synaptic
innerer => interior; inner; inside; internal; inward
wassermelone => watermelon
geritten => ridden; bestridden
chemie => chemistry
silverado => silverado
rocken => rock
knoten => knot; fasten
abbinden => bind
sadistisch => sadistic; sadistically
terrorisieren => terrorize; terrorise
durchmesser => diameter
aussortieren => assort
akustik => acoustics
respektierte => respected
habe => I've; having; have
summa => summa
glänzen => glisten; glitter
demonstrieren => demonstrate
spange => spring
collins => collins
komponieren => compose; composition; combine
pazifik => pacific ocean
aktive => live
limitierte => limited
unternehmen => undertake
neuste => newest
äh => uh
romantik => romantic
signieren => sign
pragmatisch => pragmatic; pragmatical; practical; pragmatically
eingegraben => graven
euphorisch => euphoric
zirpen => chirp
gesehen => seen
behandeln => handle
tricksen => trick
gehüpft => leapt
dealen => deal; deal <delt>
amüsant => amusing; amusingly
hinbringen => bring; to bring
lecken => lick; leak
beleuchtung => lighting
erstarren => stiffen
marguerite => marguerite
alfie => alfie
zwitschern => twitter
antworten => answer; answering
verletzen => violate
erklimmen => climb; clamber
stephanie => stephanie
herodes => herod
schwede => swede
willens => willing
geniale => ingeniously
vorschreiben => prescribe
theoretischen => theoretical
speisekammer => spence
wessen => whose
portugiesisch => Portuguese; portuguese
chinese => chinaman; chink
folter => torture
urinieren => urinate
anhalten => halt
rabbiner => rabbi
organisch => organic; organically; organicly; organ
flüssig => fluid
unhygienisch => unhygienic
demolieren => demolish
warnen => warn
schokolade => chocolate
regieren => reign
hasste => hated
eigenartig => eccentric
sabotieren => sabotage
kletterte => clambered
starten => start; start up
jerusalem => jerusalem
computer => computer; personal computer
unverwüstlich => everlasting
bestens => best
konstanz => constance
lobster => lobster
offizielle => officially
rasse => race
pyramide => pyramid
morgen => morn; morrow
livre => livre
newcastle => newcastle
aktuell => actual
batterie => battery
rahmen => frame
verschrieben => prescribed
asien => asia
tiefer => deeper
indien => india
verfangen => entangle; entangled
mike => mike
ist => is
rottweiler => rottweilers
theorie => theory
zerrissen => riven
rhetorische => rhetorically
auspacken => unpack
verlängert => longer
kränker => sicker
luther => luther
unfruchtbar => unfruitful; unproductive
telefonieren => telephone
stramm => strapping
aßen => ate; assen
buzz => buzz
elektrisches => electrically
strenger => severer; sterner; stricter
mittleres => middle; middling
freundlicher => friendlier; gentler; kindlier
kalibrieren => calibrate; calibrating; calibration
rollen => roll; roll up; coil
hydra => hydra
ausrotten => uproot
route => route
schockierende => shockingly
anwesend => present
demokratisch => democratic; democratically; democrat
finnisch => Finnish; Finnic; finnish
pädophil => pedophilic; paedophile; paedophiliac; paedophilic; pedophiliac; pedophile; pædophiliac; pædophilic
xerxes => xerxes
dame => dame
faszinieren => fascinate
siehe => see
parfüm => perfumery
etablieren => establish
geisterjäger => ghostbuster
größte => greatest
diagnose => diagnosis
nizza => nice
klappern => clatter; chatter
attackieren => attack
spaten => spade
erfroren => frozen
mathematische => mathematically; mathematics
hacken => hack
starren => stare; glare
kreative => creatively
literatur => literature
nordwestlichen => northwestwards
gefälscht => false
hunger => hunger
chester => chester
unglücklicher => unluckier
sangen => sang
letzter => latter
staffeln => stagger
militärisch => military; militarily; militant; militarism; militar
geheul => howls
traditioneller => more traditional
unterschreiben => underwrite; undersign; subscribe
scooter => scooter
selbstredend => self-evidently
schleimiger => slimier
schnappte => snapped
symmetrisch => symmetrical; symmetric; symmetrically
trotter => trotter
bernie => bernie
cutter => cutter
pathetisch => pathetic
untermauern => underpin
hängt => hangs
kalifornien => california
ununterbrochen => uninterrupted; unbroken
dichter => denser; densier; tighter
heulte => hooted; howled; ululated
exzellenter => more excellent
identifizieren => identify
mutigste => gamiest; grittiest; gutsiest
pudern => powder
brasilianer => brazilian
klaustrophobisch => claustrophobic
can => can
dreihundert => three hundred
intubieren => intubate
ap => ap
sibirien => siberia
warmherzig => warmhearted; warm hearted; warm-hearted
inspirierend => inspiring; inspirational; inspiriting
morden => murder
stressen => stress
desertieren => desert
charlotte => charlotte
schockierte => shocked
einmarschieren => march in
äußerste => outermost
fliehen => flee
trichter => crater
mutierte => mutated
richten => straighten
härter => harder
repräsentieren => represent; represents
umschreiben => circumscribe; describe
philosophisch => philosophical; philosophic; philosophically
inhalieren => inhale
together => together
anbringen => bring
wollen => will; woolen; woollen; woolly
baracke => barn
schrubben => scrub
melancholisch => melancholic; melancholy
spektakulär => spectacular; spectacularly
negativer => more negative
revidieren => revise; review
picknicken => picnic
phrase => phrase
rogers => rogers
füreinander => for one another
zurücklehnen => recline
minimale => minimal
großmama => grandma
au => ah
milwaukee => milwaukee
wurde => were
peugeot => peugeot
aussenden => send
fechten => fight; fence
perspektive => prospects
unbeständig => uncertain; unsettled; unsteady
inder => blind person; indian
reicher => richer; wealthier
suspendieren => suspend
modernste => modernest
hektische => hectically
errichtete => erected
perser => persian
kurzsichtig => short-sighted; nearsighted; shortsighted; near sighted; near-sighted; shortsightedly
umringt => rings; rung; surrounds
genetische => genetical
selbstsüchtig => selfish; selfishly; self-serving; self-seeking
einpacken => pack
interpretieren => interpret
witzige => witty
formen => form; frame; forge
providence => providence
dasselbe => itself
basen => base
telemetrie => telemetry
unbestreitbar => unquestionable
tarnen => screen
brigadier => brigadier
vorüber => over
capote => capote
dieses => itself; these
ukrainer => ukrainian; ukrainians
kommentar => comment
melbourne => melbourne
erwachen => awaken; waken
scham => shame
unlogisch => illogical
josefine => josephine
roger => roger
rouge => rouge
sitzt => sits
klemmen => clamp
inne => inside
runde => rotundly
befürwortet => supported; supports
wärmen => warm; warm up
service => serve
kürzen => shorten; cancel
sportsgeist => sportsmanship
kippte => tilted; tipped
rekrutieren => recruit
asbest => asbestos
zerschmettern => shatter
torte => torte
schockieren => shock
dämonische => demonic
guise => guise
folgender => follower
kennen => ken; known
ändern => convert
mantle => mantle
hämmern => hammer; hammering
albino => albino; albinism
innerlich => internal; inner; interior
weicher => fleecier; waxier; squishier
gefühlt => felt
kosmische => cosmic; cosmical
reservieren => reserve
simone => simone
gazette => gazette
track => track
typische => typical
indisponiert => indisposed
vorhanden => on hand
schäbiger => seedier; shabbier
übernachten => overnight
lose => loose; loosely
lüften => lift
rundherum => round about
dichten => recite
vorprogrammiert => preprogrammed
zukommen => become; come
real => real
prostituierte => prostituted
nobelpreis => nobel prize
florin => florin
bronze => bronze; bronze-colored
indonesien => indonesia
videorekorder => videocassette recorder
bruder => bruv
verdrehen => misrepresent
roy => roy
doofer => dumber
tippen => type
kultur => culture
isländer => icelander
solide => solid; solidly
welcher => which
koscher => kosher; kasher
cracker => cracker
definieren => define; defines
magere => meagerly
morse => morse
äthiopien => ethiopia
fünfte => fifth
klingelte => jingled
klonen => clone
diamanten => diamond; diamantine
konservieren => preserve; conserve
wagenladung => wagonload
leukämie => leukemia
begünstigte => benefited; benefitted
nacheinander => one after another
eingenommen => ingested
yankee => yankee
obszön => obscene; obscenely
niger => niger
zerbrochen => broken
pausieren => pause
schütze => shuttle
eingetragen => entered
automatische => automated
leiden => abide
brandneu => brand new; brand-new
reimen => rhyme
individuelle => individuals
skrupellose => unscrupulously
beginnen => begin
hungrige => hungrily
pip => pip
fotogen => photogenic; photogenically
würdiger => worthier
weinte => wept
frischer => fresher
fälschte => falsified
blitzen => lighten; flicker; glitter
kippen => tip; topple; tip over
tuberkulose => tuberculosis
unterbrochen => intermittent; interrupted; intermitted; broken
erröten => redden
digger => digger
grünen => green
kacken => make
normalisieren => normalize; normalise; nomalize
glücklicher => luckier
ernster => graver; sterner
nachgelassen => decreased
klingonisch => klingon
israel => israel
zeigte => pointed
tätowierung => tattoo
laird => laird
würmer => worm
initiieren => initiate; institute
stürmen => storm
dürr => dry
hen => hen
unterstützen => endorse; underpin
carrie => carrie
meins => mine
geschrien => cried
männlicher => manlier
metalle => metal
systematisch => systematic; systematically; systematical
strapazieren => strain
zugeschrieben => ascribed
waren => were
armenier => armenian; armenians
drache => drake
melone => melon
abliefern => deliver
routen => to route
verständlich => understandable; understandably
zusehen => see
driften => drift
garage => garage
deprimierend => depressing
sodass => so as
kühler => chillier
atmosphärische => atmospherical
doodle => doodle
realisieren => realize; realise
pcp => pcp
kommend => coming
überflutet => overflooded
schockierend => shocking; shockingly
allmächtig => almighty; almightily
quellen => well; swell
verantworten => answer; answer for; to answer for
manipulieren => manipulate; manage
eingeschlossen => enclosed
göteborg => goteborg; gothenburg
andauern => endure
dyke => dyke; dike
klingonen => klingons
clement => clement
hintere => later; hind; später; after
nürnberg => nuremberg
anker => anker
dröhnen => drone
uneingeladen => uninvited
küsste => kissed
stutzen => shorten
fiktive => fictitiously
mischte => mashed; mingled
single => single
lesbe => lezzer
jingle => jingle
provence => provence
offline => offline; off-line
konsumieren => consume; consuming
innerhalb => intra; internal; interiorly; internally; intra-
angegriffen => aggressed
neblig => nebulous
fressen => feed
mathematisch => mathematical; mathematic; mathematically
grundwasser => groundwater
libyen => libya
beantwortete => answered
sommers => in summer
romulaner => romulan; romulans
tunesien => tunisia
während => whereas; when
beweinen => bewail
bündeln => bundle
wirken => work
negative => negatively
gespalten => per pale
algier => algiers
schwellen => swell; swell up; become swollen; make swollen; swollen
umprogrammieren => reprogram
toxikologische => toxicologically
italiener => italian; italians
vulgär => vulgar; vulgarly
regnen => raining
schnüffeln => sniffle; snuffle
rosette => rosette
hygienisch => hygienic; hygienically
warner => warner
sabbern => slaver; slobber
telefonisch => telephonic; telephone; telephonically
getrieben => driven
rühmen => commend
scheußlicher => unholier; ghastlier
einparken => park
sokrates => socrates
nettesten => nicest
amerikaner => american; americans
produzieren => produce
eintausend => one thousand
brite => brit; britisher; briton
hannover => hanover
victor => victor
blockieren => block; blockade; block off
chatten => chat
fünfzig => fifty
phönix => phoenix; phenix
pfeifen => pipe
krone => koruna
gaffen => gape
blindlings => blindly; blindfold
unterschrieben => underwritten; undersigned
feilen => file
beschämen => shame
campen => camp
erleuchten => enlighten; lighten; brighten
ausdiskutieren => to dispute
zerfallen => fall
bestreben => strive; striven; striven}
mailänder => milan; milanese
achte => eighth; eighthes; eighths
schmuggelte => smuggled
tätig => acting
verwunderlich => wonderful
unterziehen => undergo
assistieren => assist
explodieren => explode
vorwerfen => threaten
killen => kill
komische => comically
klicken => click
strömen => stream
grüner => greener
reichen => reach
nachts => nighttime; nights; night
übertrumpfen => overtrump; trump; circumvent
bellen => bellow
zigarette => cigaret
maske => masker
seither => since then; since; then
heiliger => hallower; holier
serbien => serbia
bremse => break; bridle
impuls => impulsion
nordamerika => north america
epische => epical; epic
ziellos => aimless
übertrumpft => overtrumps; overtrumped
gutheißen => authorize
dieser => these
beizeiten => betimes
erfunden => unfounded
gründete => grounded
deaktivieren => deactivate; inactivate
unterwegs => on the way; underway
orange => orange; orange-coloured; orange tree; oranges
meinen => mean; opine; imagine
tendieren => tend
daphne => daphne
hysterischen => hysterically
entrüstet => enraged
größerer => greater
äquivalent => equivalent
rülpst => burps
pinkelte => tinkled
alphabetisch => alphabetical; alphabetic; alphabetically; in alphabetical order
kostspielig => costly
paaren => pair
albanien => albania
zerhacken => hack
verschreiben => prescribe; inscribe
palästinenser => palestinian; palestinians
save => sava
verrückteste => wackiest
mathematik => mathematics
gottverdammt => goddamn; goddam; goddammit
more => more
retriever => retriever
jüdisch => Jewish; jewish
joyce => joyce
schultern => shoulder
james => james
tänzer => dancer
gepumpt => pumped
engagieren => engage
damaskus => damascus
nötigen => oblige
frostig => frosty; frostily
seine => seine
zureden => urge
ballen => ball
bomben => bomb; bombing
historischen => historically
sitzen => sit; sitting
amputieren => amputate
hornissen => hornet
aussicht => sight
straff => strict
basierend => basing
tutti => tutti
äußere => outer
quaken => quack
variieren => variegate; be different
belle => belle
lauda => lauda
zögernd => lingering
faschistische => fascistically
normannen => norsemen
strömt => streams
masturbieren => masturbate
bukarest => bucharest
lahme => lamely
alleine => alone
podest => podium
tanzen => dance; dancing
hunderte => hundreds; hundredths
cassiopeia => cassiopeia
symbolisch => symbolic; symbolical; symbolically
adoptierte => adopted
farce => charade; forcemeat
steinigen => stone; stoning
zündet => kindles
fiedler => fiddler
unfreiwillig => unwilling
spitzen => sharpen
appetitlich => appetizing; appetising; appetizingly
finale => finish
date => date
hoffen => hope
gegeben => given
stärker => stronger
trailer => trailer
hackte => hacked
neurotisch => neurotic; neurotically
junker => junker
einzige => single
träumen => dreamed
glücklich => luckily
linse => lens
entweder => either
antwerpen => antwerp
exzellenz => excellence
kleiner => lesser; minor; punier; scrawnier; teenier; tinier
göttin => göttin
samen => sami
bluffen => bluff
blocks => blocks
hämmert => hammerd
dinieren => dine
weißen => whiten; white
alle => all
fühlte => felt
hielt => halted; held
lille => lille
pipeline => piping
belagerung => besieging
kammer => air-chamber
kroatien => croatia
deprimieren => depress
zander => sauger
kicken => kick
hydraulik => hydraulic
spieß => spike
gurren => curr
bestellen => reserve; tell
spencer => spencer
leuchten => brighten
fließend => fluent
unpraktisch => impractical; unpractical; impractically; nonpractical; unfunctional; unpractically
erfrieren => freeze; be frozen
steinen => stonen
starrte => stared
spit => spit
eliminieren => eliminate
politisch => political; politically; politic
parlament => parlement
greifen => seize; grip
weinend => weeping
schmutziger => smudgier; smuttier
karen => karen
geschworen => sworn
nordwärts => northward; northwards; north; northbound; northerly; to the north
endete => ended
rhetorisch => rhetorical; rhetoric; rhetorically
valentinstag => valentine's
kurve => curving
luna => luna
fine => fine
fantastische => fantastic
wiedergeboren => reborn
rechtens => right
antwortete => retorted
erfrischend => refreshing
necken => heckle
trinken => drink; take
rennen => running
entfallen => fall
artemis => artemis
lebenslänglich => life sentence; lifelong
gebissen => bitten
flotter => smarter
tätowieren => tattoo
rath => rath
dokumentieren => document; documenting
poesie => poetry
ausfüllen => filled
verehrt => venerates
undercover => cover; under; undercover
erreichen => reach
anekdote => anecdote
klingonin => klingon
anomalie => anomaly
pupille => pupil (eye)
komtesse => countess
fantastisch => fantastic
kasten => cabinet; casing
konfrontieren => confront
messung => metering
siebente => seventh
charmant => charming
verworfen => depraved
dolly => dolly
israeli => israeli
tratschen => tattle
furchtloser => doughtier
spartaner => spartan
leblose => lifelessly
sylvester => sylvester
traumatisiert => traumatised; traumatises; traumatizea; traumatized
warnt => warns
gallier => gaul
watt => watt; watts
manches => many a
schmecken => smack
kosten => cost; taste
beduinen => bedouin
knackte => cracked
traditionell => traditional; traditionally; by tradition
diese => these
vipern => viperidae
beschworen => sworn
vorgestern => ereyesterday
keines => neither
grässlich => grisly
malmö => malmo
besagen => mean; say
aorta => aorta
symbolische => symbolically
wehe => woe
ältester => oldest
brummen => grumble
jalousie => louvre
einchecken => check in
katholisch => Catholic; catholic; Catholically
warten => wait
elektronisch => electronic; electric; electronically
woher => where
donner => thunder
fünftel => fifth
zwölfte => twelfth
geschnitten => bitten
bar => bare; bar
rechts => right; right side
artikel => article
koordinieren => coordinate
lausig => lousy; lousily; lusut
ethnische => ethnical
kapitol => capitoline
diplomatisch => diplomatic; diplomatically; politic
harke => rake
lauter => louder
diversen => diverse
lausanne => lausanne
fife => fife
abgestumpft => abrupt
webseiten => websites
phantastisch => fantastically; fantastic
neurologische => neurological
kurieren => cure
schämen => shame; ashamed
beissen => bite
ebenen => make even
japanisch => Japanese; japanese; Japanisch
alter => elder
sprüht => sprays
offene => open
reykjavik => reykjavík
guam => guam
länger => longer; lengthy
konzentrieren => concentrate; center; centre
sweatshirt => sweater
neue => new
genetik => genetics
interviewen => interview
zweitausend => two thousand
medium => medium
näher => nearer
sizilianer => sicilian
angehalten => halted
kongressabgeordneter => congressman
angeboren => inborn; inbred; inherent
präsentieren => present
reaktionär => reactionary
kalif => calif
rappen => rap
effizienter => more efficient
kanadische => Canadian
sperma => spermatozoon
philosophische => philosophically
tango => tango
glühend => glowing
selbstsüchtige => selfishly
café => café
tätowiert => tattoos; tattooed
gebacken => baked; bake
verkrampfen => cramp
herüber => over here
innen => inner
anstreben => strive
drinnen => inner
feinstes => fine
pantomime => pantomime
mittlerer => middle; middling
schande => shame
trunken => drunken; drunk; crocked
erlernt => learnt
bedeutung => bearing
folgte => followed
freigeben => free
autorisieren => authorize; authorise
kaffee => coffee
regenerieren => regenerate
anstelle => instead
aller => all
dinosaurier => dinosaur; dinosaurs
misstrauisch => mistrustful
raven => rave
wrestler => wrestler
rumänien => romania; rumania
trauen => trust
grausamer => crueler; ghastlier; crueller
bostoner => boston; bostonian
brüssel => brussels
glotzen => gaze
krebs => crab
zittern => jitter
sichern => secure
analysierte => analyzed; analysed
hebräer => hebrew; hebrews
harmonisch => harmonious; harmonic; harmoniously; harmonicly; harmonical; harmonically
nippen => sip
katholische => catholically
lebensgeschichte => life cycle
marokkaner => moroccan
saboteure => saboteur
funktionierte => functioned
knacken => crack; crackle
jordanien => jordan
hören => hearken
manövriert => maneuvers
klüger => cleverer
formieren => form; forming up
regen => regen
kümmern => concern
felder => fields
sparen => save; spare
beeinflusste => influenced
runter => under
beugte => bent
untersuchte => investigated
grasen => graze
rückwärts => backwards; backward; rearward; rearwards
biologisches => biologically
psychotisch => psychotic
stuttgart => stuttgart
intelligenteste => most intelligent
spinnen => spin; spinning; invent
furchterregend => frightening
unnötige => unneeded
chemotherapie => chemotherapy
dunkle => darkly
strömte => streamed
monster => monstrosity
devonshire => devonshire
erotik => erotica
befürchten => frighten
keine => neither
tropischen => tropically
legende => legend
witziger => wittier
getroffen => stricken
biber => biber
ducken => duck
intelligenter => more intelligent
agathe => agatha
tracker => tracker
kardiologie => cardiology
nö => no
identisch => identical; identic; identically
isolieren => isolate
regnete => rained
hängen => hang; hang down; hung; hang over
federn => feather
zentrale => center; centrally
weißes => white
köln => cologne
helene => helen
tätowierte => tattooed
aria => aria
ebbe => ebbe
biologisch => biological; biologically; biologic
nisten => nest; nestle
store => store
ingwer => ginger
allee => alameda
japsen => japs
erster => first-order
sire => sire
rouen => rouen
produktivität => productiveness
inkompetent => incompetent; inefficient
fette => fat; fats; fatty
danke => thanks
interessiere => am interested in
beleuchtet => lighted
erfrischen => freshen
haben => have; have got; have to
psychisch => psychic; psychological; psychical
hindern => hinder; hamper
thriller => thriller
teleportieren => teleport
phänomenal => phenomenal; phenomenally
küssen => kiss
rücken => proceed
elektromagnetische => electromagnetically
gerammt => rammed
valentine => valentine
argumentiert => argues; argued
flüchtig => fleeting
medizinisch => medical; medicinal; medically; medic; medicinally; medicated
mütterlich => motherly
balance => balance
klammerte => clamped; clasped
barbarisch => barbaric; barbarian; barbarous; barbarously; barbarianly; barbarically
alles => all; by all means
auffrischen => freshen
widerwillig => unwilling
long => long
theoretisch => theoretical; theoretic; theoretically; theoreticly
problematisch => problematic; problematical; problematically
gegriffen => gripped
aufwecken => awake; awaken; waken
halluzinieren => hallucinate
beschreiben => describe
hyänen => hyena
jane => jane
scheuen => eschew; shun
blond => blond; blonde
stoppen => stop
trucker => trucker
ausweiten => to widen
helfen => help
wunderbare => wonderfully
bohrte => bored
praktische => practically
südafrika => south africa
software => software
grönland => greenland
symbiose => symbiosis
defensive => defensively
way => way
ordinär => ordinary
faszinierte => fascinated
empfinden => finger
namentlich => namely
bestimmen => destine
viertausend => four thousand
penelope => penelope
ausgetrickst => tricked
gefunden => funds
sympathische => sympathetically
harmlose => harmlessly
helena => helen
bestialisch => bestial; brutish
motivieren => motivate
monogamie => monogamy
bastille => bastille
western => western
schriller => shriller
unähnlich => unlike; unalike
interessanten => interestingly
camden => camden
riskanter => riskier; dicier
spektakuläre => spectacular
zone => zone
eintragen => enter
westen => west
gläsern => glassy; glass
programmierten => programmed
stoß => shot
telefone => telephones
scheinen => shine
schaben => scrape; chafe; scratch; shave
steppe => steppe
patrouillieren => patrol
laden => loading
vietnamesisch => Vietnamese; vietnamese
konsole => console table
patent => letters patent; warrant
gebeten => requested
chile => chile
janice => janice
brechen => break; breach
antarktis => antarctic; antarctica
industrie => industry
time => time
riskierten => risked
abgebrochen => aborted; broken
passen => pass
ruhiger => quieter
bohren => bore
syrer => syrian
missen => miss; be missing
gefallen => fallen
unglaublicher => unbelievablier
psychologisch => psychological; psychologically; psychologic
mailen => email; mail
hunderttausend => hundred thousand; one hundred thousand
motherfucker => motherfucker
dümmer => dumber
georgetown => georgetown
unterschätzen => underestimate; underrate; undervalue
mechanischer => mechanical
sanken => sank
knattern => chatter; to clatter
ill => ill
drastische => drastically
exotisch => exotic; exotically
ermutigen => embolden
belagern => beleaguer
belgier => belgian
kolumbianer => colombian
aktivierte => activated
elbe => elbe
gemeiner => meaner
verfeinern => refine
lernte => learned; learnt
herbringen => bring
unterstrichen => underlined; underscored
gepriesen => praised
weile => a while
kritisieren => criticize; criticise
steiler => steeper
betrunken => drunk; drunken; get drunk
turin => turin
verbarrikadieren => barricade
hugo => hugh
perverser => more perverse
schoß => shot
hopper => hopper
mores => mores
loben => commend
nimmer => never
funktionieren => function
markieren => mark
sacken => sag; sack
verpflichten => obligate
reparierte => repaired
karibik => caribbean
psychologische => psychologically
koffeinfrei => decaffeinated; caffeine-free
paradies => paradise
aaron => aaron
brasilien => brazil
dose => dose
einstweilen => meanwhile
angeschwollen => swollen
louvre => louvre
vibrieren => vibrate; vibration
unrealistisch => unrealistic; unrealistically
niederlande => netherlands
akademische => academical; academics
östrogen => estrogenic
kräftiger => beefier; heftier; lustier
version => edition
meistern => master; mastery
muskulös => muscular; muscly; muscularly
sterilisieren => sterilize; to sterilise; sterilise
bereute => regretted; repented
versäumt => overstays
untypisch => atypical; nontypical; untypical; untypically; atypic
stampfen => stomp; stamp; tamp
kochkunst => cooking
reichte => reached
passte => was suitable
zürich => zurich
füllt => fills
evakuiert => evacuated; evacuates
äußerst => utmost; outermost
wollte => would
schade => shame
distanzieren => distance oneself; distance; outdistance; dissociate
klirren => clink
letzte => latter
küche => kitchen
ruinierte => ruined
verbreitete => bruited
bestellten => bespoken
austricksen => trick
akute => acutely
hindeuten => indicate
gallien => gaul
smash => smash
burgunder => burgundian; burgundy
ärgern => anger
reserve => reserves
wales => wales
präsent => present
freigelassen => released
mimen => mime
mammuts => mammoth
niagarafälle => niagara falls
bestellte => bespoke
sichten => sight; sift
undankbare => unthankfully
dahinten => behind
undeutliche => unexplicitly
londoner => london; londoner
verehren => revere
jamaikaner => jamaican
garantierte => guaranteed; warranted
psychiatrischen => psychiatrical
pumpen => pump
ungestört => undisturbed
gebrochen => broken; heartbroken; refracted
eigenhändig => single-handedly; single-handed
jan => john
promenadendeck => promenade deck
outen => out
kälter => colder; chillier
ruinieren => ruin
kapern => capture
kreuzweise => crosswise
filzen => felting
natalie => natalia; natalie
vordere => forward; former
pasta => paste
wanderte => wandered
beides => both sides
befürworten => support
juristisch => juridical; juristic; juridic; juristical
neptun => neptune
immens => immense; immensely
überfüllt => overfilled
epilepsie => epilepsy
chicagoer => chicago
krönen => crown
wasser => water; waters
recherchiert => researched
kompensieren => compensate; compensate for
investierte => invested
abenteuerlustig => adventurous
medizinische => medically; medical
iowa => iowa
namenlose => namelessly
sicherer => securer; surer
rammen => ram
unnatürlich => unnatural; unnaturally
solches => such
kantine => cantina
ausländer => outlander
streifte => streaked; striped
träumte => dreamt
funktionsfähig => functioning; functional
öfter => often
zerstören => destroy
miauen => miaow; miaou
super => super
beitreten => get together
persönlich => personal; personally
hypnotisieren => hypnotize; to hypnotise; hypnotise
hoffte => hoped
schlummern => slumber
luise => louisa
befestigen => fasten
einleiten => initiate
jupiter => jupiter
hat => has; hath
kriechen => creep; cringe; crouch
christoph => christopher
begeben => betake; betaken
dramatische => dramatically
gebeugt => bent
knapper => scarcer; scrimpier
qualifizieren => qualify
trace => trace
stolzer => prouder
carter => carter
filtern => filter; filtrate; fine; to filter; filter out
hebe => hebe
enden => end; end up
poetisch => poetic; poetical; poetically
achilles => achilles
eskalieren => escalate
gebet => request
backstage => backstage
interagieren => interact
japaner => japanese
schnupfen => snuff
keiner => neither
gestörte => perturbed
alkmene => alcmene
halbwegs => halfway; half-way; partway
stieß => hustled
beatrice => beatrice
enger => tighter
liquidieren => liquidate
bridge => bridge
eingefügt => inset
missverstanden => misapprehended; mistaken; misunderstood
vertrauen => entrust
türkisch => Turkish; turkish
griechenland => greece
mace => mace
impotent => impotent
schrammen => scrape; scratch
finden => find
peter => peter
unterstreichen => underline; underscore
be => bee
skalpieren => scalp
zerschmetterte => shattered
unwissentlich => unwitting; unwittingly
knarren => clatter
stärken => starch
image => image
fohlen => foal
aufmachen => unfasten
wärt => were
code => code
ungeschoren => unshorn
telefonierte => telephoned
experimentierte => experimented
versklaven => enslave
branche => branch
kohlenhydrate => carbohydrate
arrangieren => arrange
granada => granada
mächtiger => mightier
weggeben => be given
neutralisieren => neutralise; neutralize
unverändert => unvaried
brocken => brake; brocken
walter => walter
genial => ingenious; ingeniously; genius; genial
budapest => budapest
steckte => stuck
ignorierte => ignored
elektrisch => electric; electrical; electrically; electronic; by electricity
andocken => dock
vorgeschrieben => prescribed
sollst => shalt
sprosse => prong
existieren => exist; existence
halten => halt
nette => nattily
prostata => prostate
marschierte => marched
links => links
chaotisch => chaotic; chaotically
champagner => champagne
betäubt => benumbs; numbs
gründet => grounds
senden => send
stammen => stem
kojoten => coyote
koran => koran; qur'an; quran
lockern => loosen; loose; slacken
seitdem => since
paket => package
akustische => acoustically
selbst => self
grunzt => grunts
seltsamer => stranger
flankieren => flank
transportieren => transport; transfer
vanille => vanilla; vanilla (spice)
wartete => waited
deponieren => deposit; depose; deposite
exekutive => executive branch
erstklassig => first-class; first class; class; classy
heulen => howl
unfreundlich => unfriendly
jazzmusik => jazz
preisen => praise
spanier => spaniard; spaniards
mittelmäßig => middling
toulouse => toulouse
labern => blather
kupfer => copper
ukraine => ukraine
römer => roemer
beschmutzen => besmirch
fauler => lazier
breiter => broader; wider
gesprungen => sprung
russe => russian
flash => flash
skandalös => scandalous; scandalously
informieren => inform
knabbern => to dabble in
genetisch => genetic; genetically; genetical; genic
schärfen => sharpen
dauern => dure
meinte => meant
gebrochene => broken
lagune => lake
johannesburg => johannesburg
über => over
makaber => macabre
bremen => bremen
allergisch => allergic; allergically; allergenic
voller => fuller
nostalgisch => nostalgic; nostalgically
schulen => school; discipline
goldfinger => goldfinger
perlen => sparkle
erreichte => reached
trällert => trolls; trills
exemplar => exemplar
klasse => class; classroom
sehen => see
annullieren => annul; nullify
chemische => chemically
zarter => softer
illegal => illegal; illegally; illicit; illegitimate; illegitimately
pünktlich => punctual
radieschen => radishes
karate => karate
hearts => hearts
schamlose => shamelessly
nachrichten => notification
majestätische => majestical
unwichtig => slight
vertiefen => deepen
junkie => junkie
brillant => brilliant; bright; brilliantly
nase => nose; nosing
hessen => hesse
christine => christina; christine
recycelt => recycled
zehn => ten
präsentiert => presents; presented
ihrer => her
angreifen => aggress
optimal => optimal; optimum; optimally
beißen => bite
störte => disturbed
französisch => french
geplündert => plundered
dekorieren => decorate
unterhalten => entertain
unabdingbar => inalienable; unalienable
klassischer => classical
grenzen => range; reach
weise => wise; wisely
george => george
zucken => quake
pariser => paris; parisian
riskierte => risked
meiner => mine
nose => nose
kurs => course
berater => mentor
philosophischen => philosophical
katastrophale => catastrophically; disastrously
planen => plan; slate
halber => half
jemen => yemen
ruhte => rested
gruppen => groups
rechte => right
lackieren => lacquer; laquer
unzureichend => insufficient
natürlich => natural; naturally; native
nordafrika => north africa
argentinien => argentina
übersee => overseas
packen => pack; package
awesome => awesome
tolerant => tolerant; tolerantly
hollywood => hollywood
zange => tong
energie => energy
restaurieren => restore
rammte => rammed
rehabilitieren => rehabilitate
vancouver => vancouver
organ => organ
bemühen => bother
majestätisch => majestic; majestically
auseinanderhalten => separate
nuklear => nuclear; nuke
observieren => observe
unterzeichnen => undersign
korallen => coral red; coral
reichste => richest
sowie => too
meridian => meridian
ratlos => at a loss
worden => were
steuerbord => starboard
westwärts => west; westward; westwards; westbound
rhythmisches => rhythmically
fünftes => fifth
saudi => saudi
leinen => linen
übermorgen => overmorrow
marschieren => march
struktur => structure
involvieren => involve
halbtags => half-time
luzifer => lucifer
kämpft => combats
tombstone => tombstone
schärfer => sharper
riskieren => risk
stopfen => stuff; stop
verwüsten => waste
blutlinie => bloodline
kreuzte => cruised
auflisten => list
spannen => span
mustern => pattern
rostiger => rustier
übernatürlich => supernaturally
qualifizierte => qualified
lieblicher => lovelier
flexibel => flexible; inflectable; flexile
ungebunden => unbound; independent
rosten => rust
privilegierten => privileged
arsen => arsenic
vergessen => forgotten
faser => fibers
produktiver => more productive
fördert => furthers; fosters
mexikanisch => Mexican; mexican; mexikan
vicomte => vicomte
radikale => radically
filter => filter
perspektiven => prospects
sternenflotte => starfleet
stabiler => sturdier
füllte => filled
betrügen => betray
provozieren => provoke; be provocative
spritzen => splatter; sprinkle; spatter; spritz
hereinbitten => invite
eurydike => eurydice
hoffentlich => hopefully
pausenlos => pauseless
reifen => ripen
unwissend => unwitting
benny => benny
joghurt => yoghurt
größter => greatest
neuer => newer
religiös => religious; religiously; believing
steifen => stiffen; to stiffen
afrikaner => african
pace => pace
romantisch => romantic; Romantic; romance; romantically; romanesque
klappen => flap; clap; clatter
hechelt => hatcheled; heckled
unterbrechen => interrupt